HeadwayId,ServiceDate: chararray,StartTimeInMin,RouteName: chararray,RouteDirectionName: chararray,Trip_1: int,Trip_2: int,StopName: bytearray,ActHeadway,ScheduledHeadway,HeadwayDifference,ID,AvgAct,AvgSch,AvgStartTime,AbsDifference,AvgDifference
1,3/1/2014,200,28,Inbound,4225233,4225234,Mattapan Station - South Busway,32,39,-7,1,34.11111111,39,207,7,4.89
1,3/1/2014,202,28,Inbound,4225233,4225234,Blue Hill Ave @ Fessenden St,32,39,-7,2,44.55555556,48.22222222,246,7,8.33
1,3/1/2014,203,28,Inbound,4225233,4225234,Blue Hill Ave @ Morton St,32,39,-7,3,26.88888889,25,294,7,7.22
1,3/1/2014,206,28,Inbound,4225233,4225234,Blue Hill Ave @ Talbot Ave,34,39,-5,4,23.09090909,27.90909091,321,5,4.82
1,3/1/2014,207,28,Inbound,4225233,4225234,Blue Hill Ave @ Ellington St - Franklin Park Zoo,35,39,-4,5,23.81818182,23,349,4,1.00
1,3/1/2014,209,28,Inbound,4225233,4225234,Warren St @ Sunderland St,35,39,-4,6,16.18181818,15,372,4,2.09
1,3/1/2014,210,28,Inbound,4225233,4225234,Warren St @ Quincy St,35,39,-4,7,18.45454545,15,387,4,3.45
1,3/1/2014,212,28,Inbound,4225233,4225234,Warren St @ Moreland St,36,39,-3,8,10.54545455,15.90909091,402,3,5.55
1,3/1/2014,213,28,Inbound,4225233,4225234,Dudley Station,36,39,-3,9,16.90909091,16.54545455,418,3,2.36
2,3/1/2014,239,28,Inbound,4225234,4225235,Mattapan Station - South Busway,37,46,-9,10,13.72727273,15,434,9,2.36
2,3/1/2014,241,28,Inbound,4225234,4225235,Blue Hill Ave @ Fessenden St,42,46,-4,11,15.09090909,15,449,4,1.00
2,3/1/2014,242,28,Inbound,4225234,4225235,Blue Hill Ave @ Morton St,42,46,-4,12,18,10,464,4,8.00
2,3/1/2014,245,28,Inbound,4225234,4225235,Blue Hill Ave @ Talbot Ave,40,47,-7,13,10.45454545,10,474,7,1.36
2,3/1/2014,246,28,Inbound,4225234,4225235,Blue Hill Ave @ Ellington St - Franklin Park Zoo,42,48,-6,14,0.272727273,10,484,6,9.73
2,3/1/2014,248,28,Inbound,4225234,4225235,Warren St @ Sunderland St,42,49,-7,15,17.36363636,11,494,7,6.36
2,3/1/2014,249,28,Inbound,4225234,4225235,Warren St @ Quincy St,42,50,-8,16,4.181818182,11,505,8,6.82
2,3/1/2014,251,28,Inbound,4225234,4225235,Warren St @ Moreland St,42,51,-9,17,21.09090909,10.90909091,516,9,10.18
2,3/1/2014,252,28,Inbound,4225234,4225235,Dudley Station,72,51,21,18,8.454545455,11.72727273,527,21,4.36
3,3/1/2014,285,28,Inbound,4225235,4199437,Mattapan Station - South Busway,29,27,2,19,8,12.36363636,539,2,4.91
3,3/1/2014,287,28,Inbound,4225235,4199437,Blue Hill Ave @ Fessenden St,30,27,3,20,9.818181818,11.90909091,551,3,2.09
3,3/1/2014,288,28,Inbound,4225235,4199437,Blue Hill Ave @ Morton St,30,27,3,21,14.54545455,11,563,3,3.55
3,3/1/2014,292,28,Inbound,4225235,4199437,Blue Hill Ave @ Talbot Ave,33,26,7,22,10.81818182,11,574,7,2.00
3,3/1/2014,294,28,Inbound,4225235,4199437,Blue Hill Ave @ Ellington St - Franklin Park Zoo,30,25,5,23,12.54545455,11,585,5,1.73
3,3/1/2014,297,28,Inbound,4225235,4199437,Warren St @ Sunderland St,29,24,5,24,14.63636364,11,596,5,4.18
3,3/1/2014,299,28,Inbound,4225235,4199437,Warren St @ Quincy St,30,23,7,25,12.27272727,11,607,7,1.64
3,3/1/2014,302,28,Inbound,4225235,4199437,Warren St @ Moreland St,31,22,9,26,9,11,618,9,2.00
3,3/1/2014,303,28,Inbound,4225235,4199437,Dudley Station,0,24,-24,27,10.90909091,11,629,24,1.73
4,3/1/2014,312,28,Inbound,4199437,4199505,Mattapan Station - South Busway,17,25,-8,28,13.09090909,10.72727273,640,8,2.36
4,3/1/2014,314,28,Inbound,4199437,4199505,Blue Hill Ave @ Fessenden St,23,25,-2,29,4.545454545,12.27272727,651,2,7.73
4,3/1/2014,315,28,Inbound,4199437,4199505,Blue Hill Ave @ Morton St,23,26,-3,30,19.81818182,11.18181818,663,3,8.64
4,3/1/2014,318,28,Inbound,4199437,4199505,Blue Hill Ave @ Talbot Ave,22,27,-5,31,3,11,675,5,8.00
4,3/1/2014,319,28,Inbound,4199437,4199505,Blue Hill Ave @ Ellington St - Franklin Park Zoo,23,28,-5,32,12.45454545,11,686,5,2.73
4,3/1/2014,321,28,Inbound,4199437,4199505,Warren St @ Sunderland St,24,29,-5,33,16.81818182,11,697,5,7.64
4,3/1/2014,322,28,Inbound,4199437,4199505,Warren St @ Quincy St,24,30,-6,34,2.636363636,11,708,6,10.73
4,3/1/2014,324,28,Inbound,4199437,4199505,Warren St @ Moreland St,24,30,-6,35,13.27272727,11,719,6,4.27
4,3/1/2014,327,28,Inbound,4199437,4199505,Dudley Station,25,29,-4,36,20.27272727,11,730,4,9.27
4,3/1/2014,329,28,Inbound,4199437,4199505,Malcolm X Blvd @ Tremont St,25,29,-4,37,0.909090909,11,741,4,10.09
4,3/1/2014,331,28,Inbound,4199437,4199505,Ruggles Sta - Upper Level,24,29,-5,38,17.09090909,11,752,5,6.09
5,3/1/2014,337,28,Inbound,4199505,4199617,Mattapan Station - South Busway,30,23,7,39,11.81818182,11,763,7,2.64
5,3/1/2014,339,28,Inbound,4199505,4199617,Blue Hill Ave @ Fessenden St,23,23,0,40,4.363636364,11,774,0,8.45
5,3/1/2014,341,28,Inbound,4199505,4199617,Blue Hill Ave @ Morton St,24,23,1,41,11.09090909,11,785,1,2.27
5,3/1/2014,345,28,Inbound,4199505,4199617,Blue Hill Ave @ Talbot Ave,23,23,0,42,11.18181818,11,796,0,1.27
5,3/1/2014,347,28,Inbound,4199505,4199617,Blue Hill Ave @ Ellington St - Franklin Park Zoo,23,23,0,43,11.45454545,11,807,0,2.09
5,3/1/2014,350,28,Inbound,4199505,4199617,Warren St @ Sunderland St,24,23,1,44,4.5,11,816,1,6.50
5,3/1/2014,352,28,Inbound,4199505,4199617,Warren St @ Quincy St,24,23,1,45,24.2,11,827,1,13.20
5,3/1/2014,354,28,Inbound,4199505,4199617,Warren St @ Moreland St,23,23,0,46,11.5,11,838,0,5.50
5,3/1/2014,356,28,Inbound,4199505,4199617,Dudley Station,23,23,0,47,0.181818182,11,851,0,11.91
5,3/1/2014,358,28,Inbound,4199505,4199617,Malcolm X Blvd @ Tremont St,23,23,0,48,14.72727273,11,862,0,5.91
5,3/1/2014,360,28,Inbound,4199505,4199617,Ruggles Sta - Upper Level,22,23,-1,49,25.27272727,11,873,1,14.27
6,3/1/2014,360,28,Inbound,4199617,4199439,Mattapan Station - South Busway,10,15,-5,50,-0.636363636,11,884,5,11.64
6,3/1/2014,362,28,Inbound,4199617,4199439,Blue Hill Ave @ Fessenden St,17,15,2,51,19.54545455,11,895,2,8.55
6,3/1/2014,364,28,Inbound,4199617,4199439,Blue Hill Ave @ Morton St,16,15,1,52,2,11,906,1,9.00
6,3/1/2014,368,28,Inbound,4199617,4199439,Blue Hill Ave @ Talbot Ave,17,15,2,53,5,11,917,2,6.91
6,3/1/2014,370,28,Inbound,4199617,4199439,Blue Hill Ave @ Ellington St - Franklin Park Zoo,17,15,2,54,13.63636364,11,928,2,2.82
6,3/1/2014,373,28,Inbound,4199617,4199439,Warren St @ Sunderland St,16,15,1,55,17.36363636,11,939,1,6.36
6,3/1/2014,375,28,Inbound,4199617,4199439,Warren St @ Quincy St,16,15,1,56,7.545454545,11,950,1,3.45
6,3/1/2014,377,28,Inbound,4199617,4199439,Warren St @ Moreland St,17,15,2,57,14.09090909,11,961,2,3.09
6,3/1/2014,379,28,Inbound,4199617,4199439,Dudley Station,17,15,2,58,4.363636364,11,972,2,7.00
6,3/1/2014,381,28,Inbound,4199617,4199439,Malcolm X Blvd @ Tremont St,17,15,2,59,16.45454545,11,983,2,5.45
6,3/1/2014,383,28,Inbound,4199617,4199439,Ruggles Sta - Upper Level,18,15,3,60,10.72727273,11,994,3,1.91
7,3/1/2014,375,28,Inbound,4199439,4200194,Mattapan Station - South Busway,18,15,3,61,11.45454545,11,1005,3,1.91
7,3/1/2014,377,28,Inbound,4199439,4200194,Blue Hill Ave @ Fessenden St,16,15,1,62,10.45454545,11,1016,1,3.09
7,3/1/2014,379,28,Inbound,4199439,4200194,Blue Hill Ave @ Morton St,17,15,2,63,16.54545455,11,1027,2,6.82
7,3/1/2014,383,28,Inbound,4199439,4200194,Blue Hill Ave @ Talbot Ave,17,15,2,64,1.909090909,11.81818182,1038,2,9.91
7,3/1/2014,385,28,Inbound,4199439,4200194,Blue Hill Ave @ Ellington St - Franklin Park Zoo,17,15,2,65,14.09090909,10.45454545,1049,2,3.64
7,3/1/2014,388,28,Inbound,4199439,4200194,Warren St @ Sunderland St,19,15,4,66,9,9.545454545,1060,4,2.18
7,3/1/2014,390,28,Inbound,4199439,4200194,Warren St @ Quincy St,19,15,4,67,19.81818182,10.45454545,1069,4,9.36
7,3/1/2014,392,28,Inbound,4199439,4200194,Warren St @ Moreland St,20,15,5,68,8.363636364,11.63636364,1080,5,4.18
7,3/1/2014,394,28,Inbound,4199439,4200194,Dudley Station,20,15,5,69,3.818181818,13,1091,5,11.36
7,3/1/2014,396,28,Inbound,4199439,4200194,Malcolm X Blvd @ Tremont St,20,15,5,70,21.90909091,13,1104,5,10.18
7,3/1/2014,398,28,Inbound,4199439,4200194,Ruggles Sta - Upper Level,20,15,5,71,2.909090909,13.36363636,1117,5,11.36
8,3/1/2014,390,28,Inbound,4200194,4200413,Mattapan Station - South Busway,4,15,-11,72,21.18181818,12.18181818,1131,11,9.55
8,3/1/2014,392,28,Inbound,4200194,4200413,Blue Hill Ave @ Fessenden St,16,15,1,73,6.727272727,11.54545455,1143,1,4.82
8,3/1/2014,394,28,Inbound,4200194,4200413,Blue Hill Ave @ Morton St,15,15,0,74,22,13,1155,0,9.00
8,3/1/2014,398,28,Inbound,4200194,4200413,Blue Hill Ave @ Talbot Ave,13,15,-2,75,2.363636364,13,1168,2,12.27
8,3/1/2014,400,28,Inbound,4200194,4200413,Blue Hill Ave @ Ellington St - Franklin Park Zoo,11,15,-4,76,14,13,1181,4,2.09
8,3/1/2014,403,28,Inbound,4200194,4200413,Warren St @ Sunderland St,10,15,-5,77,20.18181818,13,1194,5,7.18
8,3/1/2014,405,28,Inbound,4200194,4200413,Warren St @ Quincy St,9,15,-6,78,11.81818182,17,1207,6,5.18
8,3/1/2014,407,28,Inbound,4200194,4200413,Warren St @ Moreland St,8,17,-9,79,18,17,1224,9,1.36
8,3/1/2014,409,28,Inbound,4200194,4200413,Dudley Station,9,17,-8,80,12.27272727,17,1241,8,4.73
8,3/1/2014,411,28,Inbound,4200194,4200413,Malcolm X Blvd @ Tremont St,9,17,-8,81,18.09090909,17,1258,8,2.00
8,3/1/2014,413,28,Inbound,4200194,4200413,Ruggles Sta - Upper Level,12,19,-7,82,17.81818182,17,1275,7,1.73
9,3/1/2014,405,28,Inbound,4200413,4199507,Mattapan Station - South Busway,25,15,10,83,14.72727273,17.09090909,1292,10,3.27
9,3/1/2014,407,28,Inbound,4200413,4199507,Blue Hill Ave @ Fessenden St,13,16,-3,84,23.27272727,16.18181818,1309,3,7.09
9,3/1/2014,409,28,Inbound,4200413,4199507,Blue Hill Ave @ Morton St,13,16,-3,85,15.72727273,16.27272727,1325,3,2.91
9,3/1/2014,413,28,Inbound,4200413,4199507,Blue Hill Ave @ Talbot Ave,15,16,-1,86,19,17,1341,1,2.00
9,3/1/2014,415,28,Inbound,4200413,4199507,Blue Hill Ave @ Ellington St - Franklin Park Zoo,15,17,-2,87,11.63636364,17,1358,2,5.36
9,3/1/2014,418,28,Inbound,4200413,4199507,Warren St @ Sunderland St,16,17,-1,88,14.81818182,17,1375,1,2.55
9,3/1/2014,420,28,Inbound,4200413,4199507,Warren St @ Quincy St,17,17,0,89,19.09090909,15.90909091,1392,0,3.18
9,3/1/2014,424,28,Inbound,4200413,4199507,Warren St @ Moreland St,19,17,2,90,12.36363636,15.45454545,1408,2,3.09
9,3/1/2014,426,28,Inbound,4200413,4199507,Dudley Station,18,17,1,91,20,17,1423,1,4.27
9,3/1/2014,428,28,Inbound,4200413,4199507,Malcolm X Blvd @ Tremont St,19,17,2,92,26.81818182,17,1440,2,9.82
9,3/1/2014,432,28,Inbound,4200413,4199507,Ruggles Sta - Upper Level,16,17,-1,93,9.909090909,17,1457,1,7.09
10,3/1/2014,420,28,Inbound,4199507,4199619,Mattapan Station - South Busway,5,15,-10,94,11.3,17,1473,10,7.10
10,3/1/2014,423,28,Inbound,4199507,4199619,Blue Hill Ave @ Fessenden St,13,15,-2,95,16.4,17,1490,2,1.20
10,3/1/2014,425,28,Inbound,4199507,4199619,Blue Hill Ave @ Morton St,14,15,-1,,,,,1,
10,3/1/2014,429,28,Inbound,4199507,4199619,Blue Hill Ave @ Talbot Ave,15,15,0,,,,,0,
10,3/1/2014,432,28,Inbound,4199507,4199619,Blue Hill Ave @ Ellington St - Franklin Park Zoo,17,15,2,,,,,2,
10,3/1/2014,435,28,Inbound,4199507,4199619,Warren St @ Sunderland St,17,15,2,,,,,2,
10,3/1/2014,437,28,Inbound,4199507,4199619,Warren St @ Quincy St,17,15,2,,,,,2,
10,3/1/2014,441,28,Inbound,4199507,4199619,Warren St @ Moreland St,14,15,-1,,,,,1,
10,3/1/2014,443,28,Inbound,4199507,4199619,Dudley Station,14,15,-1,,,,,1,
10,3/1/2014,445,28,Inbound,4199507,4199619,Malcolm X Blvd @ Tremont St,12,15,-3,,,,,3,
10,3/1/2014,449,28,Inbound,4199507,4199619,Ruggles Sta - Upper Level,13,15,-2,,,,,2,
11,3/1/2014,435,28,Inbound,4199619,4199441,Mattapan Station - South Busway,16,15,1,,,,,1,
11,3/1/2014,438,28,Inbound,4199619,4199441,Blue Hill Ave @ Fessenden St,17,15,2,,,,,2,
11,3/1/2014,440,28,Inbound,4199619,4199441,Blue Hill Ave @ Morton St,16,15,1,,,,,1,
11,3/1/2014,444,28,Inbound,4199619,4199441,Blue Hill Ave @ Talbot Ave,15,15,0,,,,,0,
11,3/1/2014,447,28,Inbound,4199619,4199441,Blue Hill Ave @ Ellington St - Franklin Park Zoo,15,15,0,,,,,0,
11,3/1/2014,450,28,Inbound,4199619,4199441,Warren St @ Sunderland St,13,15,-2,,,,,2,
11,3/1/2014,452,28,Inbound,4199619,4199441,Warren St @ Quincy St,13,15,-2,,,,,2,
11,3/1/2014,456,28,Inbound,4199619,4199441,Warren St @ Moreland St,14,15,-1,,,,,1,
11,3/1/2014,458,28,Inbound,4199619,4199441,Dudley Station,15,15,0,,,,,0,
11,3/1/2014,460,28,Inbound,4199619,4199441,Malcolm X Blvd @ Tremont St,16,15,1,,,,,1,
11,3/1/2014,464,28,Inbound,4199619,4199441,Ruggles Sta - Upper Level,16,15,1,,,,,1,
12,3/1/2014,450,28,Inbound,4199441,4200196,Mattapan Station - South Busway,20,10,10,,,,,10,
12,3/1/2014,453,28,Inbound,4199441,4200196,Blue Hill Ave @ Fessenden St,15,10,5,,,,,5,
12,3/1/2014,455,28,Inbound,4199441,4200196,Blue Hill Ave @ Morton St,16,10,6,,,,,6,
12,3/1/2014,459,28,Inbound,4199441,4200196,Blue Hill Ave @ Talbot Ave,18,10,8,,,,,8,
12,3/1/2014,462,28,Inbound,4199441,4200196,Blue Hill Ave @ Ellington St - Franklin Park Zoo,17,10,7,,,,,7,
12,3/1/2014,465,28,Inbound,4199441,4200196,Warren St @ Sunderland St,19,10,9,,,,,9,
12,3/1/2014,467,28,Inbound,4199441,4200196,Warren St @ Quincy St,19,10,9,,,,,9,
12,3/1/2014,471,28,Inbound,4199441,4200196,Warren St @ Moreland St,19,10,9,,,,,9,
12,3/1/2014,473,28,Inbound,4199441,4200196,Dudley Station,18,10,8,,,,,8,
12,3/1/2014,475,28,Inbound,4199441,4200196,Malcolm X Blvd @ Tremont St,19,10,9,,,,,9,
12,3/1/2014,479,28,Inbound,4199441,4200196,Ruggles Sta - Upper Level,18,10,8,,,,,8,
13,3/1/2014,460,28,Inbound,4200196,4200332,Mattapan Station - South Busway,20,10,10,,,,,10,
13,3/1/2014,463,28,Inbound,4200196,4200332,Blue Hill Ave @ Fessenden St,10,10,0,,,,,0,
13,3/1/2014,465,28,Inbound,4200196,4200332,Blue Hill Ave @ Morton St,9,10,-1,,,,,1,
13,3/1/2014,469,28,Inbound,4200196,4200332,Blue Hill Ave @ Talbot Ave,9,10,-1,,,,,1,
13,3/1/2014,472,28,Inbound,4200196,4200332,Blue Hill Ave @ Ellington St - Franklin Park Zoo,9,10,-1,,,,,1,
13,3/1/2014,475,28,Inbound,4200196,4200332,Warren St @ Sunderland St,9,10,-1,,,,,1,
13,3/1/2014,477,28,Inbound,4200196,4200332,Warren St @ Quincy St,10,10,0,,,,,0,
13,3/1/2014,481,28,Inbound,4200196,4200332,Warren St @ Moreland St,10,10,0,,,,,0,
13,3/1/2014,483,28,Inbound,4200196,4200332,Dudley Station,9,10,-1,,,,,1,
13,3/1/2014,485,28,Inbound,4200196,4200332,Malcolm X Blvd @ Tremont St,10,10,0,,,,,0,
13,3/1/2014,489,28,Inbound,4200196,4200332,Ruggles Sta - Upper Level,10,10,0,,,,,0,
14,3/1/2014,470,28,Inbound,4200332,4200377,Mattapan Station - South Busway,-6,10,-16,,,,,16,
14,3/1/2014,473,28,Inbound,4200332,4200377,Blue Hill Ave @ Fessenden St,4,10,-6,,,,,6,
14,3/1/2014,475,28,Inbound,4200332,4200377,Blue Hill Ave @ Morton St,4,10,-6,,,,,6,
14,3/1/2014,479,28,Inbound,4200332,4200377,Blue Hill Ave @ Talbot Ave,2,10,-8,,,,,8,
14,3/1/2014,482,28,Inbound,4200332,4200377,Blue Hill Ave @ Ellington St - Franklin Park Zoo,2,10,-8,,,,,8,
14,3/1/2014,485,28,Inbound,4200332,4200377,Warren St @ Sunderland St,2,10,-8,,,,,8,
14,3/1/2014,487,28,Inbound,4200332,4200377,Warren St @ Quincy St,0,10,-10,,,,,10,
14,3/1/2014,491,28,Inbound,4200332,4200377,Warren St @ Moreland St,-1,10,-11,,,,,11,
14,3/1/2014,493,28,Inbound,4200332,4200377,Dudley Station,0,10,-10,,,,,10,
14,3/1/2014,495,28,Inbound,4200332,4200377,Malcolm X Blvd @ Tremont St,-2,10,-12,,,,,12,
14,3/1/2014,499,28,Inbound,4200332,4200377,Ruggles Sta - Upper Level,-2,10,-12,,,,,12,
15,3/1/2014,480,28,Inbound,4200377,4200415,Mattapan Station - South Busway,12,11,1,,,,,1,
15,3/1/2014,483,28,Inbound,4200377,4200415,Blue Hill Ave @ Fessenden St,12,11,1,,,,,1,
15,3/1/2014,485,28,Inbound,4200377,4200415,Blue Hill Ave @ Morton St,13,11,2,,,,,2,
15,3/1/2014,489,28,Inbound,4200377,4200415,Blue Hill Ave @ Talbot Ave,15,11,4,,,,,4,
15,3/1/2014,492,28,Inbound,4200377,4200415,Blue Hill Ave @ Ellington St - Franklin Park Zoo,16,11,5,,,,,5,
15,3/1/2014,495,28,Inbound,4200377,4200415,Warren St @ Sunderland St,16,11,5,,,,,5,
15,3/1/2014,497,28,Inbound,4200377,4200415,Warren St @ Quincy St,19,11,8,,,,,8,
15,3/1/2014,501,28,Inbound,4200377,4200415,Warren St @ Moreland St,21,11,10,,,,,10,
15,3/1/2014,503,28,Inbound,4200377,4200415,Dudley Station,21,11,10,,,,,10,
15,3/1/2014,505,28,Inbound,4200377,4200415,Malcolm X Blvd @ Tremont St,22,11,11,,,,,11,
15,3/1/2014,509,28,Inbound,4200377,4200415,Ruggles Sta - Upper Level,24,11,13,,,,,13,
16,3/1/2014,491,28,Inbound,4200415,4200487,Mattapan Station - South Busway,4,11,-7,,,,,7,
16,3/1/2014,494,28,Inbound,4200415,4200487,Blue Hill Ave @ Fessenden St,10,11,-1,,,,,1,
16,3/1/2014,496,28,Inbound,4200415,4200487,Blue Hill Ave @ Morton St,10,11,-1,,,,,1,
16,3/1/2014,500,28,Inbound,4200415,4200487,Blue Hill Ave @ Talbot Ave,7,11,-4,,,,,4,
16,3/1/2014,503,28,Inbound,4200415,4200487,Blue Hill Ave @ Ellington St - Franklin Park Zoo,6,11,-5,,,,,5,
16,3/1/2014,506,28,Inbound,4200415,4200487,Warren St @ Sunderland St,4,11,-7,,,,,7,
16,3/1/2014,508,28,Inbound,4200415,4200487,Warren St @ Quincy St,2,11,-9,,,,,9,
16,3/1/2014,512,28,Inbound,4200415,4200487,Warren St @ Moreland St,1,11,-10,,,,,10,
16,3/1/2014,514,28,Inbound,4200415,4200487,Dudley Station,1,11,-10,,,,,10,
16,3/1/2014,516,28,Inbound,4200415,4200487,Malcolm X Blvd @ Tremont St,1,11,-10,,,,,10,
16,3/1/2014,520,28,Inbound,4200415,4200487,Ruggles Sta - Upper Level,0,11,-11,,,,,11,
17,3/1/2014,502,28,Inbound,4200487,4199509,Mattapan Station - South Busway,16,11,5,,,,,5,
17,3/1/2014,505,28,Inbound,4200487,4199509,Blue Hill Ave @ Fessenden St,11,11,0,,,,,0,
17,3/1/2014,507,28,Inbound,4200487,4199509,Blue Hill Ave @ Morton St,12,11,1,,,,,1,
17,3/1/2014,511,28,Inbound,4200487,4199509,Blue Hill Ave @ Talbot Ave,15,11,4,,,,,4,
17,3/1/2014,514,28,Inbound,4200487,4199509,Blue Hill Ave @ Ellington St - Franklin Park Zoo,15,11,4,,,,,4,
17,3/1/2014,517,28,Inbound,4200487,4199509,Warren St @ Sunderland St,20,11,9,,,,,9,
17,3/1/2014,519,28,Inbound,4200487,4199509,Warren St @ Quincy St,24,11,13,,,,,13,
17,3/1/2014,523,28,Inbound,4200487,4199509,Warren St @ Moreland St,28,11,17,,,,,17,
17,3/1/2014,525,28,Inbound,4200487,4199509,Dudley Station,29,11,18,,,,,18,
17,3/1/2014,527,28,Inbound,4200487,4199509,Malcolm X Blvd @ Tremont St,30,11,19,,,,,19,
17,3/1/2014,531,28,Inbound,4200487,4199509,Ruggles Sta - Upper Level,32,10,22,,,,,22,
18,3/1/2014,513,28,Inbound,4199509,4199549,Mattapan Station - South Busway,8,11,-3,,,,,3,
18,3/1/2014,516,28,Inbound,4199509,4199549,Blue Hill Ave @ Fessenden St,14,11,3,,,,,3,
18,3/1/2014,518,28,Inbound,4199509,4199549,Blue Hill Ave @ Morton St,13,11,2,,,,,2,
18,3/1/2014,522,28,Inbound,4199509,4199549,Blue Hill Ave @ Talbot Ave,11,11,0,,,,,0,
18,3/1/2014,525,28,Inbound,4199509,4199549,Blue Hill Ave @ Ellington St - Franklin Park Zoo,12,11,1,,,,,1,
18,3/1/2014,528,28,Inbound,4199509,4199549,Warren St @ Sunderland St,11,11,0,,,,,0,
18,3/1/2014,530,28,Inbound,4199509,4199549,Warren St @ Quincy St,7,12,-5,,,,,5,
18,3/1/2014,534,28,Inbound,4199509,4199549,Warren St @ Moreland St,5,11,-6,,,,,6,
18,3/1/2014,536,28,Inbound,4199509,4199549,Dudley Station,5,13,-8,,,,,8,
18,3/1/2014,538,28,Inbound,4199509,4199549,Malcolm X Blvd @ Tremont St,5,14,-9,,,,,9,
18,3/1/2014,541,28,Inbound,4199509,4199549,Ruggles Sta - Upper Level,2,13,-11,,,,,11,
19,3/1/2014,524,28,Inbound,4199549,4199621,Mattapan Station - South Busway,14,11,3,,,,,3,
19,3/1/2014,527,28,Inbound,4199549,4199621,Blue Hill Ave @ Fessenden St,9,11,-2,,,,,2,
19,3/1/2014,529,28,Inbound,4199549,4199621,Blue Hill Ave @ Morton St,9,11,-2,,,,,2,
19,3/1/2014,533,28,Inbound,4199549,4199621,Blue Hill Ave @ Talbot Ave,10,12,-2,,,,,2,
19,3/1/2014,536,28,Inbound,4199549,4199621,Blue Hill Ave @ Ellington St - Franklin Park Zoo,10,13,-3,,,,,3,
19,3/1/2014,539,28,Inbound,4199549,4199621,Warren St @ Sunderland St,7,13,-6,,,,,6,
19,3/1/2014,542,28,Inbound,4199549,4199621,Warren St @ Quincy St,7,13,-6,,,,,6,
19,3/1/2014,545,28,Inbound,4199549,4199621,Warren St @ Moreland St,6,13,-7,,,,,7,
19,3/1/2014,549,28,Inbound,4199549,4199621,Dudley Station,5,13,-8,,,,,8,
19,3/1/2014,552,28,Inbound,4199549,4199621,Malcolm X Blvd @ Tremont St,5,13,-8,,,,,8,
19,3/1/2014,554,28,Inbound,4199549,4199621,Ruggles Sta - Upper Level,6,13,-7,,,,,7,
20,3/1/2014,535,28,Inbound,4199621,4199443,Mattapan Station - South Busway,8,11,-3,,,,,3,
20,3/1/2014,538,28,Inbound,4199621,4199443,Blue Hill Ave @ Fessenden St,10,12,-2,,,,,2,
20,3/1/2014,540,28,Inbound,4199621,4199443,Blue Hill Ave @ Morton St,10,12,-2,,,,,2,
20,3/1/2014,545,28,Inbound,4199621,4199443,Blue Hill Ave @ Talbot Ave,10,12,-2,,,,,2,
20,3/1/2014,549,28,Inbound,4199621,4199443,Blue Hill Ave @ Ellington St - Franklin Park Zoo,10,12,-2,,,,,2,
20,3/1/2014,552,28,Inbound,4199621,4199443,Warren St @ Sunderland St,10,12,-2,,,,,2,
20,3/1/2014,555,28,Inbound,4199621,4199443,Warren St @ Quincy St,10,12,-2,,,,,2,
20,3/1/2014,558,28,Inbound,4199621,4199443,Warren St @ Moreland St,10,12,-2,,,,,2,
20,3/1/2014,562,28,Inbound,4199621,4199443,Dudley Station,10,12,-2,,,,,2,
20,3/1/2014,565,28,Inbound,4199621,4199443,Malcolm X Blvd @ Tremont St,10,12,-2,,,,,2,
20,3/1/2014,567,28,Inbound,4199621,4199443,Ruggles Sta - Upper Level,10,12,-2,,,,,2,
21,3/1/2014,546,28,Inbound,4199443,4199899,Mattapan Station - South Busway,12,11,1,,,,,1,
21,3/1/2014,550,28,Inbound,4199443,4199899,Blue Hill Ave @ Fessenden St,13,11,2,,,,,2,
21,3/1/2014,552,28,Inbound,4199443,4199899,Blue Hill Ave @ Morton St,12,11,1,,,,,1,
21,3/1/2014,557,28,Inbound,4199443,4199899,Blue Hill Ave @ Talbot Ave,13,11,2,,,,,2,
21,3/1/2014,561,28,Inbound,4199443,4199899,Blue Hill Ave @ Ellington St - Franklin Park Zoo,13,11,2,,,,,2,
21,3/1/2014,564,28,Inbound,4199443,4199899,Warren St @ Sunderland St,14,11,3,,,,,3,
21,3/1/2014,567,28,Inbound,4199443,4199899,Warren St @ Quincy St,15,11,4,,,,,4,
21,3/1/2014,570,28,Inbound,4199443,4199899,Warren St @ Moreland St,16,11,5,,,,,5,
21,3/1/2014,574,28,Inbound,4199443,4199899,Dudley Station,17,11,6,,,,,6,
21,3/1/2014,577,28,Inbound,4199443,4199899,Malcolm X Blvd @ Tremont St,17,11,6,,,,,6,
21,3/1/2014,579,28,Inbound,4199443,4199899,Ruggles Sta - Upper Level,18,11,7,,,,,7,
22,3/1/2014,557,28,Inbound,4199899,4200334,Mattapan Station - South Busway,16,11,5,,,,,5,
22,3/1/2014,561,28,Inbound,4199899,4200334,Blue Hill Ave @ Fessenden St,11,11,0,,,,,0,
22,3/1/2014,563,28,Inbound,4199899,4200334,Blue Hill Ave @ Morton St,12,11,1,,,,,1,
22,3/1/2014,568,28,Inbound,4199899,4200334,Blue Hill Ave @ Talbot Ave,11,11,0,,,,,0,
22,3/1/2014,572,28,Inbound,4199899,4200334,Blue Hill Ave @ Ellington St - Franklin Park Zoo,13,11,2,,,,,2,
22,3/1/2014,575,28,Inbound,4199899,4200334,Warren St @ Sunderland St,13,11,2,,,,,2,
22,3/1/2014,578,28,Inbound,4199899,4200334,Warren St @ Quincy St,11,11,0,,,,,0,
22,3/1/2014,581,28,Inbound,4199899,4200334,Warren St @ Moreland St,10,11,-1,,,,,1,
22,3/1/2014,585,28,Inbound,4199899,4200334,Dudley Station,9,11,-2,,,,,2,
22,3/1/2014,588,28,Inbound,4199899,4200334,Malcolm X Blvd @ Tremont St,7,11,-4,,,,,4,
22,3/1/2014,590,28,Inbound,4199899,4200334,Ruggles Sta - Upper Level,6,11,-5,,,,,5,
23,3/1/2014,568,28,Inbound,4200334,4200379,Mattapan Station - South Busway,10,11,-1,,,,,1,
23,3/1/2014,572,28,Inbound,4200334,4200379,Blue Hill Ave @ Fessenden St,13,11,2,,,,,2,
23,3/1/2014,574,28,Inbound,4200334,4200379,Blue Hill Ave @ Morton St,14,11,3,,,,,3,
23,3/1/2014,579,28,Inbound,4200334,4200379,Blue Hill Ave @ Talbot Ave,13,11,2,,,,,2,
23,3/1/2014,583,28,Inbound,4200334,4200379,Blue Hill Ave @ Ellington St - Franklin Park Zoo,12,11,1,,,,,1,
23,3/1/2014,586,28,Inbound,4200334,4200379,Warren St @ Sunderland St,11,11,0,,,,,0,
23,3/1/2014,589,28,Inbound,4200334,4200379,Warren St @ Quincy St,12,11,1,,,,,1,
23,3/1/2014,592,28,Inbound,4200334,4200379,Warren St @ Moreland St,11,11,0,,,,,0,
23,3/1/2014,596,28,Inbound,4200334,4200379,Dudley Station,12,11,1,,,,,1,
23,3/1/2014,599,28,Inbound,4200334,4200379,Malcolm X Blvd @ Tremont St,14,11,3,,,,,3,
23,3/1/2014,601,28,Inbound,4200334,4200379,Ruggles Sta - Upper Level,16,11,5,,,,,5,
24,3/1/2014,579,28,Inbound,4200379,4200417,Mattapan Station - South Busway,18,11,7,,,,,7,
24,3/1/2014,583,28,Inbound,4200379,4200417,Blue Hill Ave @ Fessenden St,10,11,-1,,,,,1,
24,3/1/2014,585,28,Inbound,4200379,4200417,Blue Hill Ave @ Morton St,9,11,-2,,,,,2,
24,3/1/2014,590,28,Inbound,4200379,4200417,Blue Hill Ave @ Talbot Ave,14,11,3,,,,,3,
24,3/1/2014,594,28,Inbound,4200379,4200417,Blue Hill Ave @ Ellington St - Franklin Park Zoo,12,11,1,,,,,1,
24,3/1/2014,597,28,Inbound,4200379,4200417,Warren St @ Sunderland St,13,11,2,,,,,2,
24,3/1/2014,600,28,Inbound,4200379,4200417,Warren St @ Quincy St,15,11,4,,,,,4,
24,3/1/2014,603,28,Inbound,4200379,4200417,Warren St @ Moreland St,18,11,7,,,,,7,
24,3/1/2014,607,28,Inbound,4200379,4200417,Dudley Station,18,11,7,,,,,7,
24,3/1/2014,610,28,Inbound,4200379,4200417,Malcolm X Blvd @ Tremont St,18,11,7,,,,,7,
24,3/1/2014,612,28,Inbound,4200379,4200417,Ruggles Sta - Upper Level,16,11,5,,,,,5,
25,3/1/2014,590,28,Inbound,4200417,4200489,Mattapan Station - South Busway,18,11,7,,,,,7,
25,3/1/2014,594,28,Inbound,4200417,4200489,Blue Hill Ave @ Fessenden St,13,11,2,,,,,2,
25,3/1/2014,596,28,Inbound,4200417,4200489,Blue Hill Ave @ Morton St,14,11,3,,,,,3,
25,3/1/2014,601,28,Inbound,4200417,4200489,Blue Hill Ave @ Talbot Ave,11,11,0,,,,,0,
25,3/1/2014,605,28,Inbound,4200417,4200489,Blue Hill Ave @ Ellington St - Franklin Park Zoo,12,11,1,,,,,1,
25,3/1/2014,608,28,Inbound,4200417,4200489,Warren St @ Sunderland St,13,11,2,,,,,2,
25,3/1/2014,611,28,Inbound,4200417,4200489,Warren St @ Quincy St,12,11,1,,,,,1,
25,3/1/2014,614,28,Inbound,4200417,4200489,Warren St @ Moreland St,11,11,0,,,,,0,
25,3/1/2014,618,28,Inbound,4200417,4200489,Dudley Station,11,11,0,,,,,0,
25,3/1/2014,621,28,Inbound,4200417,4200489,Malcolm X Blvd @ Tremont St,10,11,-1,,,,,1,
25,3/1/2014,623,28,Inbound,4200417,4200489,Ruggles Sta - Upper Level,10,11,-1,,,,,1,
26,3/1/2014,601,28,Inbound,4200489,4199511,Mattapan Station - South Busway,10,11,-1,,,,,1,
26,3/1/2014,605,28,Inbound,4200489,4199511,Blue Hill Ave @ Fessenden St,10,11,-1,,,,,1,
26,3/1/2014,607,28,Inbound,4200489,4199511,Blue Hill Ave @ Morton St,9,11,-2,,,,,2,
26,3/1/2014,612,28,Inbound,4200489,4199511,Blue Hill Ave @ Talbot Ave,9,11,-2,,,,,2,
26,3/1/2014,616,28,Inbound,4200489,4199511,Blue Hill Ave @ Ellington St - Franklin Park Zoo,8,11,-3,,,,,3,
26,3/1/2014,619,28,Inbound,4200489,4199511,Warren St @ Sunderland St,9,11,-2,,,,,2,
26,3/1/2014,622,28,Inbound,4200489,4199511,Warren St @ Quincy St,8,11,-3,,,,,3,
26,3/1/2014,625,28,Inbound,4200489,4199511,Warren St @ Moreland St,9,11,-2,,,,,2,
26,3/1/2014,629,28,Inbound,4200489,4199511,Dudley Station,8,11,-3,,,,,3,
26,3/1/2014,632,28,Inbound,4200489,4199511,Malcolm X Blvd @ Tremont St,9,11,-2,,,,,2,
26,3/1/2014,634,28,Inbound,4200489,4199511,Ruggles Sta - Upper Level,10,11,-1,,,,,1,
27,3/1/2014,612,28,Inbound,4199511,4199551,Mattapan Station - South Busway,2,11,-9,,,,,9,
27,3/1/2014,616,28,Inbound,4199511,4199551,Blue Hill Ave @ Fessenden St,11,11,0,,,,,0,
27,3/1/2014,618,28,Inbound,4199511,4199551,Blue Hill Ave @ Morton St,11,11,0,,,,,0,
27,3/1/2014,623,28,Inbound,4199511,4199551,Blue Hill Ave @ Talbot Ave,11,11,0,,,,,0,
27,3/1/2014,627,28,Inbound,4199511,4199551,Blue Hill Ave @ Ellington St - Franklin Park Zoo,12,11,1,,,,,1,
27,3/1/2014,630,28,Inbound,4199511,4199551,Warren St @ Sunderland St,13,11,2,,,,,2,
27,3/1/2014,633,28,Inbound,4199511,4199551,Warren St @ Quincy St,14,11,3,,,,,3,
27,3/1/2014,636,28,Inbound,4199511,4199551,Warren St @ Moreland St,12,11,1,,,,,1,
27,3/1/2014,640,28,Inbound,4199511,4199551,Dudley Station,13,11,2,,,,,2,
27,3/1/2014,643,28,Inbound,4199511,4199551,Malcolm X Blvd @ Tremont St,11,11,0,,,,,0,
27,3/1/2014,645,28,Inbound,4199511,4199551,Ruggles Sta - Upper Level,10,11,-1,,,,,1,
28,3/1/2014,623,28,Inbound,4199551,4199623,Mattapan Station - South Busway,24,11,13,,,,,13,
28,3/1/2014,627,28,Inbound,4199551,4199623,Blue Hill Ave @ Fessenden St,13,11,2,,,,,2,
28,3/1/2014,629,28,Inbound,4199551,4199623,Blue Hill Ave @ Morton St,13,11,2,,,,,2,
28,3/1/2014,634,28,Inbound,4199551,4199623,Blue Hill Ave @ Talbot Ave,13,11,2,,,,,2,
28,3/1/2014,638,28,Inbound,4199551,4199623,Blue Hill Ave @ Ellington St - Franklin Park Zoo,14,11,3,,,,,3,
28,3/1/2014,641,28,Inbound,4199551,4199623,Warren St @ Sunderland St,11,11,0,,,,,0,
28,3/1/2014,644,28,Inbound,4199551,4199623,Warren St @ Quincy St,11,11,0,,,,,0,
28,3/1/2014,647,28,Inbound,4199551,4199623,Warren St @ Moreland St,11,11,0,,,,,0,
28,3/1/2014,651,28,Inbound,4199551,4199623,Dudley Station,10,10,0,,,,,0,
28,3/1/2014,654,28,Inbound,4199551,4199623,Malcolm X Blvd @ Tremont St,12,10,2,,,,,2,
28,3/1/2014,656,28,Inbound,4199551,4199623,Ruggles Sta - Upper Level,12,10,2,,,,,2,
29,3/1/2014,634,28,Inbound,4199623,4199804,Mattapan Station - South Busway,-12,11,-23,,,,,23,
29,3/1/2014,638,28,Inbound,4199623,4199804,Blue Hill Ave @ Fessenden St,6,11,-5,,,,,5,
29,3/1/2014,640,28,Inbound,4199623,4199804,Blue Hill Ave @ Morton St,5,11,-6,,,,,6,
29,3/1/2014,645,28,Inbound,4199623,4199804,Blue Hill Ave @ Talbot Ave,5,11,-6,,,,,6,
29,3/1/2014,649,28,Inbound,4199623,4199804,Blue Hill Ave @ Ellington St - Franklin Park Zoo,4,11,-7,,,,,7,
29,3/1/2014,652,28,Inbound,4199623,4199804,Warren St @ Sunderland St,7,14,-7,,,,,7,
29,3/1/2014,655,28,Inbound,4199623,4199804,Warren St @ Quincy St,7,13,-6,,,,,6,
29,3/1/2014,658,28,Inbound,4199623,4199804,Warren St @ Moreland St,7,14,-7,,,,,7,
29,3/1/2014,661,28,Inbound,4199623,4199804,Dudley Station,8,13,-5,,,,,5,
29,3/1/2014,664,28,Inbound,4199623,4199804,Malcolm X Blvd @ Tremont St,7,13,-6,,,,,6,
29,3/1/2014,666,28,Inbound,4199623,4199804,Ruggles Sta - Upper Level,6,13,-7,,,,,7,
30,3/1/2014,645,28,Inbound,4199804,4199445,Mattapan Station - South Busway,14,11,3,,,,,3,
30,3/1/2014,649,28,Inbound,4199804,4199445,Blue Hill Ave @ Fessenden St,16,11,5,,,,,5,
30,3/1/2014,651,28,Inbound,4199804,4199445,Blue Hill Ave @ Morton St,17,12,5,,,,,5,
30,3/1/2014,656,28,Inbound,4199804,4199445,Blue Hill Ave @ Talbot Ave,20,12,8,,,,,8,
30,3/1/2014,660,28,Inbound,4199804,4199445,Blue Hill Ave @ Ellington St - Franklin Park Zoo,20,11,9,,,,,9,
30,3/1/2014,666,28,Inbound,4199804,4199445,Warren St @ Sunderland St,20,11,9,,,,,9,
30,3/1/2014,668,28,Inbound,4199804,4199445,Warren St @ Quincy St,21,11,10,,,,,10,
30,3/1/2014,672,28,Inbound,4199804,4199445,Warren St @ Moreland St,23,11,12,,,,,12,
30,3/1/2014,674,28,Inbound,4199804,4199445,Dudley Station,22,11,11,,,,,11,
30,3/1/2014,677,28,Inbound,4199804,4199445,Malcolm X Blvd @ Tremont St,22,11,11,,,,,11,
30,3/1/2014,679,28,Inbound,4199804,4199445,Ruggles Sta - Upper Level,23,11,12,,,,,12,
31,3/1/2014,656,28,Inbound,4199445,4199901,Mattapan Station - South Busway,8,11,-3,,,,,3,
31,3/1/2014,660,28,Inbound,4199445,4199901,Blue Hill Ave @ Fessenden St,7,11,-4,,,,,4,
31,3/1/2014,663,28,Inbound,4199445,4199901,Blue Hill Ave @ Morton St,7,11,-4,,,,,4,
31,3/1/2014,668,28,Inbound,4199445,4199901,Blue Hill Ave @ Talbot Ave,3,11,-8,,,,,8,
31,3/1/2014,671,28,Inbound,4199445,4199901,Blue Hill Ave @ Ellington St - Franklin Park Zoo,2,11,-9,,,,,9,
31,3/1/2014,677,28,Inbound,4199445,4199901,Warren St @ Sunderland St,1,11,-10,,,,,10,
31,3/1/2014,679,28,Inbound,4199445,4199901,Warren St @ Quincy St,1,11,-10,,,,,10,
31,3/1/2014,683,28,Inbound,4199445,4199901,Warren St @ Moreland St,0,11,-11,,,,,11,
31,3/1/2014,685,28,Inbound,4199445,4199901,Dudley Station,1,11,-10,,,,,10,
31,3/1/2014,688,28,Inbound,4199445,4199901,Malcolm X Blvd @ Tremont St,2,11,-9,,,,,9,
31,3/1/2014,690,28,Inbound,4199445,4199901,Ruggles Sta - Upper Level,1,11,-10,,,,,10,
32,3/1/2014,667,28,Inbound,4199901,4200336,Mattapan Station - South Busway,21,11,10,,,,,10,
32,3/1/2014,671,28,Inbound,4199901,4200336,Blue Hill Ave @ Fessenden St,14,11,3,,,,,3,
32,3/1/2014,674,28,Inbound,4199901,4200336,Blue Hill Ave @ Morton St,13,11,2,,,,,2,
32,3/1/2014,679,28,Inbound,4199901,4200336,Blue Hill Ave @ Talbot Ave,14,11,3,,,,,3,
32,3/1/2014,682,28,Inbound,4199901,4200336,Blue Hill Ave @ Ellington St - Franklin Park Zoo,15,11,4,,,,,4,
32,3/1/2014,688,28,Inbound,4199901,4200336,Warren St @ Sunderland St,12,11,1,,,,,1,
32,3/1/2014,690,28,Inbound,4199901,4200336,Warren St @ Quincy St,11,11,0,,,,,0,
32,3/1/2014,694,28,Inbound,4199901,4200336,Warren St @ Moreland St,10,11,-1,,,,,1,
32,3/1/2014,696,28,Inbound,4199901,4200336,Dudley Station,9,11,-2,,,,,2,
32,3/1/2014,699,28,Inbound,4199901,4200336,Malcolm X Blvd @ Tremont St,8,11,-3,,,,,3,
32,3/1/2014,701,28,Inbound,4199901,4200336,Ruggles Sta - Upper Level,10,11,-1,,,,,1,
33,3/1/2014,678,28,Inbound,4200336,4200381,Mattapan Station - South Busway,1,11,-10,,,,,10,
33,3/1/2014,682,28,Inbound,4200336,4200381,Blue Hill Ave @ Fessenden St,15,11,4,,,,,4,
33,3/1/2014,685,28,Inbound,4200336,4200381,Blue Hill Ave @ Morton St,16,11,5,,,,,5,
33,3/1/2014,690,28,Inbound,4200336,4200381,Blue Hill Ave @ Talbot Ave,17,11,6,,,,,6,
33,3/1/2014,693,28,Inbound,4200336,4200381,Blue Hill Ave @ Ellington St - Franklin Park Zoo,18,11,7,,,,,7,
33,3/1/2014,699,28,Inbound,4200336,4200381,Warren St @ Sunderland St,20,11,9,,,,,9,
33,3/1/2014,701,28,Inbound,4200336,4200381,Warren St @ Quincy St,20,11,9,,,,,9,
33,3/1/2014,705,28,Inbound,4200336,4200381,Warren St @ Moreland St,20,11,9,,,,,9,
33,3/1/2014,707,28,Inbound,4200336,4200381,Dudley Station,20,11,9,,,,,9,
33,3/1/2014,710,28,Inbound,4200336,4200381,Malcolm X Blvd @ Tremont St,20,11,9,,,,,9,
33,3/1/2014,712,28,Inbound,4200336,4200381,Ruggles Sta - Upper Level,18,11,7,,,,,7,
34,3/1/2014,689,28,Inbound,4200381,4200419,Mattapan Station - South Busway,24,11,13,,,,,13,
34,3/1/2014,693,28,Inbound,4200381,4200419,Blue Hill Ave @ Fessenden St,3,11,-8,,,,,8,
34,3/1/2014,696,28,Inbound,4200381,4200419,Blue Hill Ave @ Morton St,2,11,-9,,,,,9,
34,3/1/2014,701,28,Inbound,4200381,4200419,Blue Hill Ave @ Talbot Ave,1,11,-10,,,,,10,
34,3/1/2014,704,28,Inbound,4200381,4200419,Blue Hill Ave @ Ellington St - Franklin Park Zoo,0,11,-11,,,,,11,
34,3/1/2014,710,28,Inbound,4200381,4200419,Warren St @ Sunderland St,0,11,-11,,,,,11,
34,3/1/2014,712,28,Inbound,4200381,4200419,Warren St @ Quincy St,-1,11,-12,,,,,12,
34,3/1/2014,716,28,Inbound,4200381,4200419,Warren St @ Moreland St,0,11,-11,,,,,11,
34,3/1/2014,718,28,Inbound,4200381,4200419,Dudley Station,0,11,-11,,,,,11,
34,3/1/2014,721,28,Inbound,4200381,4200419,Malcolm X Blvd @ Tremont St,0,11,-11,,,,,11,
34,3/1/2014,723,28,Inbound,4200381,4200419,Ruggles Sta - Upper Level,0,11,-11,,,,,11,
35,3/1/2014,700,28,Inbound,4200419,4200491,Mattapan Station - South Busway,0,11,-11,,,,,11,
35,3/1/2014,704,28,Inbound,4200419,4200491,Blue Hill Ave @ Fessenden St,11,11,0,,,,,0,
35,3/1/2014,707,28,Inbound,4200419,4200491,Blue Hill Ave @ Morton St,13,11,2,,,,,2,
35,3/1/2014,712,28,Inbound,4200419,4200491,Blue Hill Ave @ Talbot Ave,14,11,3,,,,,3,
35,3/1/2014,715,28,Inbound,4200419,4200491,Blue Hill Ave @ Ellington St - Franklin Park Zoo,15,11,4,,,,,4,
35,3/1/2014,721,28,Inbound,4200419,4200491,Warren St @ Sunderland St,15,11,4,,,,,4,
35,3/1/2014,723,28,Inbound,4200419,4200491,Warren St @ Quincy St,14,11,3,,,,,3,
35,3/1/2014,727,28,Inbound,4200419,4200491,Warren St @ Moreland St,14,11,3,,,,,3,
35,3/1/2014,729,28,Inbound,4200419,4200491,Dudley Station,16,11,5,,,,,5,
35,3/1/2014,732,28,Inbound,4200419,4200491,Malcolm X Blvd @ Tremont St,16,11,5,,,,,5,
35,3/1/2014,734,28,Inbound,4200419,4200491,Ruggles Sta - Upper Level,18,11,7,,,,,7,
36,3/1/2014,711,28,Inbound,4200491,4199513,Mattapan Station - South Busway,22,11,11,,,,,11,
36,3/1/2014,715,28,Inbound,4200491,4199513,Blue Hill Ave @ Fessenden St,20,11,9,,,,,9,
36,3/1/2014,718,28,Inbound,4200491,4199513,Blue Hill Ave @ Morton St,19,11,8,,,,,8,
36,3/1/2014,723,28,Inbound,4200491,4199513,Blue Hill Ave @ Talbot Ave,20,11,9,,,,,9,
36,3/1/2014,726,28,Inbound,4200491,4199513,Blue Hill Ave @ Ellington St - Franklin Park Zoo,20,11,9,,,,,9,
36,3/1/2014,732,28,Inbound,4200491,4199513,Warren St @ Sunderland St,20,11,9,,,,,9,
36,3/1/2014,734,28,Inbound,4200491,4199513,Warren St @ Quincy St,21,11,10,,,,,10,
36,3/1/2014,738,28,Inbound,4200491,4199513,Warren St @ Moreland St,21,11,10,,,,,10,
36,3/1/2014,740,28,Inbound,4200491,4199513,Dudley Station,20,11,9,,,,,9,
36,3/1/2014,743,28,Inbound,4200491,4199513,Malcolm X Blvd @ Tremont St,20,11,9,,,,,9,
36,3/1/2014,745,28,Inbound,4200491,4199513,Ruggles Sta - Upper Level,20,11,9,,,,,9,
37,3/1/2014,722,28,Inbound,4199513,4199553,Mattapan Station - South Busway,2,11,-9,,,,,9,
37,3/1/2014,726,28,Inbound,4199513,4199553,Blue Hill Ave @ Fessenden St,4,11,-7,,,,,7,
37,3/1/2014,729,28,Inbound,4199513,4199553,Blue Hill Ave @ Morton St,4,11,-7,,,,,7,
37,3/1/2014,734,28,Inbound,4199513,4199553,Blue Hill Ave @ Talbot Ave,1,11,-10,,,,,10,
37,3/1/2014,737,28,Inbound,4199513,4199553,Blue Hill Ave @ Ellington St - Franklin Park Zoo,0,11,-11,,,,,11,
37,3/1/2014,743,28,Inbound,4199513,4199553,Warren St @ Sunderland St,0,11,-11,,,,,11,
37,3/1/2014,745,28,Inbound,4199513,4199553,Warren St @ Quincy St,-1,11,-12,,,,,12,
37,3/1/2014,749,28,Inbound,4199513,4199553,Warren St @ Moreland St,0,11,-11,,,,,11,
37,3/1/2014,751,28,Inbound,4199513,4199553,Dudley Station,0,11,-11,,,,,11,
37,3/1/2014,754,28,Inbound,4199513,4199553,Malcolm X Blvd @ Tremont St,0,11,-11,,,,,11,
37,3/1/2014,756,28,Inbound,4199513,4199553,Ruggles Sta - Upper Level,0,11,-11,,,,,11,
38,3/1/2014,733,28,Inbound,4199553,4199625,Mattapan Station - South Busway,18,11,7,,,,,7,
38,3/1/2014,737,28,Inbound,4199553,4199625,Blue Hill Ave @ Fessenden St,15,11,4,,,,,4,
38,3/1/2014,740,28,Inbound,4199553,4199625,Blue Hill Ave @ Morton St,16,11,5,,,,,5,
38,3/1/2014,745,28,Inbound,4199553,4199625,Blue Hill Ave @ Talbot Ave,17,11,6,,,,,6,
38,3/1/2014,748,28,Inbound,4199553,4199625,Blue Hill Ave @ Ellington St - Franklin Park Zoo,18,11,7,,,,,7,
38,3/1/2014,754,28,Inbound,4199553,4199625,Warren St @ Sunderland St,18,11,7,,,,,7,
38,3/1/2014,756,28,Inbound,4199553,4199625,Warren St @ Quincy St,19,11,8,,,,,8,
38,3/1/2014,760,28,Inbound,4199553,4199625,Warren St @ Moreland St,17,11,6,,,,,6,
38,3/1/2014,762,28,Inbound,4199553,4199625,Dudley Station,17,11,6,,,,,6,
38,3/1/2014,765,28,Inbound,4199553,4199625,Malcolm X Blvd @ Tremont St,17,11,6,,,,,6,
38,3/1/2014,767,28,Inbound,4199553,4199625,Ruggles Sta - Upper Level,16,11,5,,,,,5,
39,3/1/2014,744,28,Inbound,4199625,4199806,Mattapan Station - South Busway,5,11,-6,,,,,6,
39,3/1/2014,748,28,Inbound,4199625,4199806,Blue Hill Ave @ Fessenden St,10,11,-1,,,,,1,
39,3/1/2014,751,28,Inbound,4199625,4199806,Blue Hill Ave @ Morton St,10,11,-1,,,,,1,
39,3/1/2014,756,28,Inbound,4199625,4199806,Blue Hill Ave @ Talbot Ave,10,11,-1,,,,,1,
39,3/1/2014,759,28,Inbound,4199625,4199806,Blue Hill Ave @ Ellington St - Franklin Park Zoo,10,11,-1,,,,,1,
39,3/1/2014,765,28,Inbound,4199625,4199806,Warren St @ Sunderland St,11,11,0,,,,,0,
39,3/1/2014,767,28,Inbound,4199625,4199806,Warren St @ Quincy St,13,11,2,,,,,2,
39,3/1/2014,771,28,Inbound,4199625,4199806,Warren St @ Moreland St,15,11,4,,,,,4,
39,3/1/2014,773,28,Inbound,4199625,4199806,Dudley Station,15,11,4,,,,,4,
39,3/1/2014,776,28,Inbound,4199625,4199806,Malcolm X Blvd @ Tremont St,15,11,4,,,,,4,
39,3/1/2014,778,28,Inbound,4199625,4199806,Ruggles Sta - Upper Level,16,11,5,,,,,5,
40,3/1/2014,755,28,Inbound,4199806,4199447,Mattapan Station - South Busway,21,11,10,,,,,10,
40,3/1/2014,759,28,Inbound,4199806,4199447,Blue Hill Ave @ Fessenden St,7,11,-4,,,,,4,
40,3/1/2014,762,28,Inbound,4199806,4199447,Blue Hill Ave @ Morton St,6,11,-5,,,,,5,
40,3/1/2014,767,28,Inbound,4199806,4199447,Blue Hill Ave @ Talbot Ave,5,11,-6,,,,,6,
40,3/1/2014,770,28,Inbound,4199806,4199447,Blue Hill Ave @ Ellington St - Franklin Park Zoo,4,11,-7,,,,,7,
40,3/1/2014,776,28,Inbound,4199806,4199447,Warren St @ Sunderland St,4,11,-7,,,,,7,
40,3/1/2014,778,28,Inbound,4199806,4199447,Warren St @ Quincy St,2,11,-9,,,,,9,
40,3/1/2014,782,28,Inbound,4199806,4199447,Warren St @ Moreland St,0,11,-11,,,,,11,
40,3/1/2014,784,28,Inbound,4199806,4199447,Dudley Station,-1,11,-12,,,,,12,
40,3/1/2014,787,28,Inbound,4199806,4199447,Malcolm X Blvd @ Tremont St,0,11,-11,,,,,11,
40,3/1/2014,789,28,Inbound,4199806,4199447,Ruggles Sta - Upper Level,0,11,-11,,,,,11,
41,3/1/2014,766,28,Inbound,4199447,4199903,Mattapan Station - South Busway,-1,11,-12,,,,,12,
41,3/1/2014,770,28,Inbound,4199447,4199903,Blue Hill Ave @ Fessenden St,12,11,1,,,,,1,
41,3/1/2014,773,28,Inbound,4199447,4199903,Blue Hill Ave @ Morton St,11,11,0,,,,,0,
41,3/1/2014,778,28,Inbound,4199447,4199903,Blue Hill Ave @ Talbot Ave,13,11,2,,,,,2,
41,3/1/2014,781,28,Inbound,4199447,4199903,Blue Hill Ave @ Ellington St - Franklin Park Zoo,12,11,1,,,,,1,
41,3/1/2014,787,28,Inbound,4199447,4199903,Warren St @ Sunderland St,11,11,0,,,,,0,
41,3/1/2014,789,28,Inbound,4199447,4199903,Warren St @ Quincy St,13,11,2,,,,,2,
41,3/1/2014,793,28,Inbound,4199447,4199903,Warren St @ Moreland St,13,11,2,,,,,2,
41,3/1/2014,795,28,Inbound,4199447,4199903,Dudley Station,14,11,3,,,,,3,
41,3/1/2014,798,28,Inbound,4199447,4199903,Malcolm X Blvd @ Tremont St,12,11,1,,,,,1,
41,3/1/2014,800,28,Inbound,4199447,4199903,Ruggles Sta - Upper Level,12,11,1,,,,,1,
42,3/1/2014,777,28,Inbound,4199903,4199739,Mattapan Station - South Busway,5,11,-6,,,,,6,
42,3/1/2014,781,28,Inbound,4199903,4199739,Blue Hill Ave @ Fessenden St,11,11,0,,,,,0,
42,3/1/2014,784,28,Inbound,4199903,4199739,Blue Hill Ave @ Morton St,12,11,1,,,,,1,
42,3/1/2014,789,28,Inbound,4199903,4199739,Blue Hill Ave @ Talbot Ave,12,11,1,,,,,1,
42,3/1/2014,792,28,Inbound,4199903,4199739,Blue Hill Ave @ Ellington St - Franklin Park Zoo,13,11,2,,,,,2,
42,3/1/2014,798,28,Inbound,4199903,4199739,Warren St @ Sunderland St,13,11,2,,,,,2,
42,3/1/2014,800,28,Inbound,4199903,4199739,Warren St @ Quincy St,12,11,1,,,,,1,
42,3/1/2014,804,28,Inbound,4199903,4199739,Warren St @ Moreland St,12,11,1,,,,,1,
42,3/1/2014,806,28,Inbound,4199903,4199739,Dudley Station,11,11,0,,,,,0,
42,3/1/2014,809,28,Inbound,4199903,4199739,Malcolm X Blvd @ Tremont St,11,11,0,,,,,0,
42,3/1/2014,811,28,Inbound,4199903,4199739,Ruggles Sta - Upper Level,11,11,0,,,,,0,
43,3/1/2014,788,28,Inbound,4199739,4200383,Mattapan Station - South Busway,20,11,9,,,,,9,
43,3/1/2014,792,28,Inbound,4199739,4200383,Blue Hill Ave @ Fessenden St,12,11,1,,,,,1,
43,3/1/2014,795,28,Inbound,4199739,4200383,Blue Hill Ave @ Morton St,12,11,1,,,,,1,
43,3/1/2014,800,28,Inbound,4199739,4200383,Blue Hill Ave @ Talbot Ave,10,11,-1,,,,,1,
43,3/1/2014,803,28,Inbound,4199739,4200383,Blue Hill Ave @ Ellington St - Franklin Park Zoo,10,11,-1,,,,,1,
43,3/1/2014,809,28,Inbound,4199739,4200383,Warren St @ Sunderland St,9,11,-2,,,,,2,
43,3/1/2014,811,28,Inbound,4199739,4200383,Warren St @ Quincy St,9,11,-2,,,,,2,
43,3/1/2014,815,28,Inbound,4199739,4200383,Warren St @ Moreland St,9,11,-2,,,,,2,
43,3/1/2014,817,28,Inbound,4199739,4200383,Dudley Station,10,11,-1,,,,,1,
43,3/1/2014,820,28,Inbound,4199739,4200383,Malcolm X Blvd @ Tremont St,12,11,1,,,,,1,
43,3/1/2014,822,28,Inbound,4199739,4200383,Ruggles Sta - Upper Level,13,11,2,,,,,2,
44,3/1/2014,799,28,Inbound,4200383,4200421,Mattapan Station - South Busway,0,11,-11,,,,,11,
44,3/1/2014,803,28,Inbound,4200383,4200421,Blue Hill Ave @ Fessenden St,5,11,-6,,,,,6,
44,3/1/2014,806,28,Inbound,4200383,4200421,Blue Hill Ave @ Morton St,4,11,-7,,,,,7,
44,3/1/2014,811,28,Inbound,4200383,4200421,Blue Hill Ave @ Talbot Ave,5,11,-6,,,,,6,
44,3/1/2014,814,28,Inbound,4200383,4200421,Blue Hill Ave @ Ellington St - Franklin Park Zoo,5,11,-6,,,,,6,
44,3/1/2014,820,28,Inbound,4200383,4200421,Warren St @ Sunderland St,7,11,-4,,,,,4,
44,3/1/2014,822,28,Inbound,4200383,4200421,Warren St @ Quincy St,6,11,-5,,,,,5,
44,3/1/2014,826,28,Inbound,4200383,4200421,Warren St @ Moreland St,5,11,-6,,,,,6,
44,3/1/2014,828,28,Inbound,4200383,4200421,Dudley Station,5,11,-6,,,,,6,
44,3/1/2014,831,28,Inbound,4200383,4200421,Malcolm X Blvd @ Tremont St,3,11,-8,,,,,8,
45,3/1/2014,810,28,Inbound,4200421,4200524,Mattapan Station - South Busway,19,11,8,,,,,8,
45,3/1/2014,814,28,Inbound,4200421,4200524,Blue Hill Ave @ Fessenden St,16,11,5,,,,,5,
45,3/1/2014,817,28,Inbound,4200421,4200524,Blue Hill Ave @ Morton St,17,11,6,,,,,6,
45,3/1/2014,822,28,Inbound,4200421,4200524,Blue Hill Ave @ Talbot Ave,20,11,9,,,,,9,
45,3/1/2014,825,28,Inbound,4200421,4200524,Blue Hill Ave @ Ellington St - Franklin Park Zoo,21,11,10,,,,,10,
45,3/1/2014,831,28,Inbound,4200421,4200524,Warren St @ Sunderland St,26,11,15,,,,,15,
45,3/1/2014,833,28,Inbound,4200421,4200524,Warren St @ Quincy St,28,11,17,,,,,17,
45,3/1/2014,837,28,Inbound,4200421,4200524,Warren St @ Moreland St,32,11,21,,,,,21,
45,3/1/2014,839,28,Inbound,4200421,4200524,Dudley Station,31,11,20,,,,,20,
45,3/1/2014,842,28,Inbound,4200421,4200524,Malcolm X Blvd @ Tremont St,32,11,21,,,,,21,
46,3/1/2014,821,28,Inbound,4200524,4199515,Mattapan Station - South Busway,19,11,8,,,,,8,
46,3/1/2014,825,28,Inbound,4200524,4199515,Blue Hill Ave @ Fessenden St,18,11,7,,,,,7,
46,3/1/2014,828,28,Inbound,4200524,4199515,Blue Hill Ave @ Morton St,19,11,8,,,,,8,
46,3/1/2014,833,28,Inbound,4200524,4199515,Blue Hill Ave @ Talbot Ave,15,11,4,,,,,4,
46,3/1/2014,836,28,Inbound,4200524,4199515,Blue Hill Ave @ Ellington St - Franklin Park Zoo,14,11,3,,,,,3,
46,3/1/2014,842,28,Inbound,4200524,4199515,Warren St @ Sunderland St,9,11,-2,,,,,2,
46,3/1/2014,844,28,Inbound,4200524,4199515,Warren St @ Quincy St,8,11,-3,,,,,3,
46,3/1/2014,848,28,Inbound,4200524,4199515,Warren St @ Moreland St,4,11,-7,,,,,7,
46,3/1/2014,850,28,Inbound,4200524,4199515,Dudley Station,5,11,-6,,,,,6,
46,3/1/2014,853,28,Inbound,4200524,4199515,Malcolm X Blvd @ Tremont St,4,11,-7,,,,,7,
47,3/1/2014,832,28,Inbound,4199515,4199600,Mattapan Station - South Busway,17,11,6,,,,,6,
47,3/1/2014,836,28,Inbound,4199515,4199600,Blue Hill Ave @ Fessenden St,1,11,-10,,,,,10,
47,3/1/2014,839,28,Inbound,4199515,4199600,Blue Hill Ave @ Morton St,0,11,-11,,,,,11,
47,3/1/2014,844,28,Inbound,4199515,4199600,Blue Hill Ave @ Talbot Ave,0,11,-11,,,,,11,
47,3/1/2014,847,28,Inbound,4199515,4199600,Blue Hill Ave @ Ellington St - Franklin Park Zoo,-1,11,-12,,,,,12,
47,3/1/2014,853,28,Inbound,4199515,4199600,Warren St @ Sunderland St,-2,11,-13,,,,,13,
47,3/1/2014,855,28,Inbound,4199515,4199600,Warren St @ Quincy St,-2,11,-13,,,,,13,
47,3/1/2014,859,28,Inbound,4199515,4199600,Warren St @ Moreland St,-3,11,-14,,,,,14,
47,3/1/2014,861,28,Inbound,4199515,4199600,Dudley Station,-3,11,-14,,,,,14,
47,3/1/2014,864,28,Inbound,4199515,4199600,Malcolm X Blvd @ Tremont St,-3,11,-14,,,,,14,
47,3/1/2014,866,28,Inbound,4199515,4199600,Ruggles Sta - Upper Level,-2,11,-13,,,,,13,
48,3/1/2014,843,28,Inbound,4199600,4199627,Mattapan Station - South Busway,-1,11,-12,,,,,12,
48,3/1/2014,847,28,Inbound,4199600,4199627,Blue Hill Ave @ Fessenden St,11,11,0,,,,,0,
48,3/1/2014,850,28,Inbound,4199600,4199627,Blue Hill Ave @ Morton St,12,11,1,,,,,1,
48,3/1/2014,855,28,Inbound,4199600,4199627,Blue Hill Ave @ Talbot Ave,15,11,4,,,,,4,
48,3/1/2014,858,28,Inbound,4199600,4199627,Blue Hill Ave @ Ellington St - Franklin Park Zoo,16,11,5,,,,,5,
48,3/1/2014,864,28,Inbound,4199600,4199627,Warren St @ Sunderland St,17,11,6,,,,,6,
48,3/1/2014,866,28,Inbound,4199600,4199627,Warren St @ Quincy St,16,11,5,,,,,5,
48,3/1/2014,870,28,Inbound,4199600,4199627,Warren St @ Moreland St,19,11,8,,,,,8,
48,3/1/2014,872,28,Inbound,4199600,4199627,Dudley Station,19,11,8,,,,,8,
48,3/1/2014,875,28,Inbound,4199600,4199627,Malcolm X Blvd @ Tremont St,20,11,9,,,,,9,
48,3/1/2014,877,28,Inbound,4199600,4199627,Ruggles Sta - Upper Level,18,11,7,,,,,7,
49,3/1/2014,854,28,Inbound,4199627,4199808,Mattapan Station - South Busway,21,11,10,,,,,10,
49,3/1/2014,858,28,Inbound,4199627,4199808,Blue Hill Ave @ Fessenden St,24,11,13,,,,,13,
49,3/1/2014,861,28,Inbound,4199627,4199808,Blue Hill Ave @ Morton St,24,11,13,,,,,13,
49,3/1/2014,866,28,Inbound,4199627,4199808,Blue Hill Ave @ Talbot Ave,25,11,14,,,,,14,
49,3/1/2014,869,28,Inbound,4199627,4199808,Blue Hill Ave @ Ellington St - Franklin Park Zoo,25,11,14,,,,,14,
49,3/1/2014,875,28,Inbound,4199627,4199808,Warren St @ Sunderland St,24,11,13,,,,,13,
49,3/1/2014,877,28,Inbound,4199627,4199808,Warren St @ Quincy St,26,11,15,,,,,15,
49,3/1/2014,881,28,Inbound,4199627,4199808,Warren St @ Moreland St,27,11,16,,,,,16,
49,3/1/2014,883,28,Inbound,4199627,4199808,Dudley Station,27,11,16,,,,,16,
49,3/1/2014,886,28,Inbound,4199627,4199808,Malcolm X Blvd @ Tremont St,27,11,16,,,,,16,
49,3/1/2014,888,28,Inbound,4199627,4199808,Ruggles Sta - Upper Level,28,11,17,,,,,17,
50,3/1/2014,865,28,Inbound,4199808,4199720,Mattapan Station - South Busway,-5,11,-16,,,,,16,
50,3/1/2014,869,28,Inbound,4199808,4199720,Blue Hill Ave @ Fessenden St,0,11,-11,,,,,11,
50,3/1/2014,872,28,Inbound,4199808,4199720,Blue Hill Ave @ Morton St,2,11,-9,,,,,9,
50,3/1/2014,877,28,Inbound,4199808,4199720,Blue Hill Ave @ Talbot Ave,-2,11,-13,,,,,13,
50,3/1/2014,880,28,Inbound,4199808,4199720,Blue Hill Ave @ Ellington St - Franklin Park Zoo,-1,11,-12,,,,,12,
50,3/1/2014,886,28,Inbound,4199808,4199720,Warren St @ Sunderland St,1,11,-10,,,,,10,
50,3/1/2014,888,28,Inbound,4199808,4199720,Warren St @ Quincy St,1,11,-10,,,,,10,
50,3/1/2014,892,28,Inbound,4199808,4199720,Warren St @ Moreland St,0,11,-11,,,,,11,
50,3/1/2014,894,28,Inbound,4199808,4199720,Dudley Station,-1,11,-12,,,,,12,
50,3/1/2014,897,28,Inbound,4199808,4199720,Malcolm X Blvd @ Tremont St,0,11,-11,,,,,11,
50,3/1/2014,899,28,Inbound,4199808,4199720,Ruggles Sta - Upper Level,-2,11,-13,,,,,13,
51,3/1/2014,876,28,Inbound,4199720,4199905,Mattapan Station - South Busway,21,11,10,,,,,10,
51,3/1/2014,880,28,Inbound,4199720,4199905,Blue Hill Ave @ Fessenden St,22,11,11,,,,,11,
51,3/1/2014,883,28,Inbound,4199720,4199905,Blue Hill Ave @ Morton St,19,11,8,,,,,8,
51,3/1/2014,888,28,Inbound,4199720,4199905,Blue Hill Ave @ Talbot Ave,22,11,11,,,,,11,
51,3/1/2014,891,28,Inbound,4199720,4199905,Blue Hill Ave @ Ellington St - Franklin Park Zoo,21,11,10,,,,,10,
51,3/1/2014,897,28,Inbound,4199720,4199905,Warren St @ Sunderland St,19,11,8,,,,,8,
51,3/1/2014,899,28,Inbound,4199720,4199905,Warren St @ Quincy St,18,11,7,,,,,7,
51,3/1/2014,903,28,Inbound,4199720,4199905,Warren St @ Moreland St,18,11,7,,,,,7,
51,3/1/2014,905,28,Inbound,4199720,4199905,Dudley Station,19,11,8,,,,,8,
51,3/1/2014,908,28,Inbound,4199720,4199905,Malcolm X Blvd @ Tremont St,18,11,7,,,,,7,
51,3/1/2014,910,28,Inbound,4199720,4199905,Ruggles Sta - Upper Level,18,11,7,,,,,7,
52,3/1/2014,887,28,Inbound,4199905,4199741,Mattapan Station - South Busway,1,11,-10,,,,,10,
52,3/1/2014,891,28,Inbound,4199905,4199741,Blue Hill Ave @ Fessenden St,3,11,-8,,,,,8,
52,3/1/2014,894,28,Inbound,4199905,4199741,Blue Hill Ave @ Morton St,4,11,-7,,,,,7,
52,3/1/2014,899,28,Inbound,4199905,4199741,Blue Hill Ave @ Talbot Ave,0,11,-11,,,,,11,
52,3/1/2014,902,28,Inbound,4199905,4199741,Blue Hill Ave @ Ellington St - Franklin Park Zoo,1,11,-10,,,,,10,
52,3/1/2014,908,28,Inbound,4199905,4199741,Warren St @ Sunderland St,2,11,-9,,,,,9,
52,3/1/2014,910,28,Inbound,4199905,4199741,Warren St @ Quincy St,1,11,-10,,,,,10,
52,3/1/2014,914,28,Inbound,4199905,4199741,Warren St @ Moreland St,2,11,-9,,,,,9,
52,3/1/2014,916,28,Inbound,4199905,4199741,Dudley Station,2,11,-9,,,,,9,
52,3/1/2014,919,28,Inbound,4199905,4199741,Malcolm X Blvd @ Tremont St,2,11,-9,,,,,9,
52,3/1/2014,921,28,Inbound,4199905,4199741,Ruggles Sta - Upper Level,4,11,-7,,,,,7,
53,3/1/2014,898,28,Inbound,4199741,4200385,Mattapan Station - South Busway,16,11,5,,,,,5,
53,3/1/2014,902,28,Inbound,4199741,4200385,Blue Hill Ave @ Fessenden St,8,11,-3,,,,,3,
53,3/1/2014,905,28,Inbound,4199741,4200385,Blue Hill Ave @ Morton St,6,11,-5,,,,,5,
53,3/1/2014,910,28,Inbound,4199741,4200385,Blue Hill Ave @ Talbot Ave,7,11,-4,,,,,4,
53,3/1/2014,913,28,Inbound,4199741,4200385,Blue Hill Ave @ Ellington St - Franklin Park Zoo,5,11,-6,,,,,6,
53,3/1/2014,919,28,Inbound,4199741,4200385,Warren St @ Sunderland St,3,11,-8,,,,,8,
53,3/1/2014,921,28,Inbound,4199741,4200385,Warren St @ Quincy St,4,11,-7,,,,,7,
53,3/1/2014,925,28,Inbound,4199741,4200385,Warren St @ Moreland St,1,11,-10,,,,,10,
53,3/1/2014,927,28,Inbound,4199741,4200385,Dudley Station,1,11,-10,,,,,10,
53,3/1/2014,930,28,Inbound,4199741,4200385,Malcolm X Blvd @ Tremont St,2,11,-9,,,,,9,
53,3/1/2014,932,28,Inbound,4199741,4200385,Ruggles Sta - Upper Level,2,11,-9,,,,,9,
54,3/1/2014,909,28,Inbound,4200385,4200423,Mattapan Station - South Busway,10,11,-1,,,,,1,
54,3/1/2014,913,28,Inbound,4200385,4200423,Blue Hill Ave @ Fessenden St,11,11,0,,,,,0,
54,3/1/2014,916,28,Inbound,4200385,4200423,Blue Hill Ave @ Morton St,12,11,1,,,,,1,
54,3/1/2014,921,28,Inbound,4200385,4200423,Blue Hill Ave @ Talbot Ave,11,11,0,,,,,0,
54,3/1/2014,924,28,Inbound,4200385,4200423,Blue Hill Ave @ Ellington St - Franklin Park Zoo,12,11,1,,,,,1,
54,3/1/2014,930,28,Inbound,4200385,4200423,Warren St @ Sunderland St,15,11,4,,,,,4,
54,3/1/2014,932,28,Inbound,4200385,4200423,Warren St @ Quincy St,14,11,3,,,,,3,
54,3/1/2014,936,28,Inbound,4200385,4200423,Warren St @ Moreland St,16,11,5,,,,,5,
54,3/1/2014,938,28,Inbound,4200385,4200423,Dudley Station,16,11,5,,,,,5,
54,3/1/2014,941,28,Inbound,4200385,4200423,Malcolm X Blvd @ Tremont St,17,11,6,,,,,6,
54,3/1/2014,943,28,Inbound,4200385,4200423,Ruggles Sta - Upper Level,16,11,5,,,,,5,
55,3/1/2014,920,28,Inbound,4200423,4200526,Mattapan Station - South Busway,18,11,7,,,,,7,
55,3/1/2014,924,28,Inbound,4200423,4200526,Blue Hill Ave @ Fessenden St,13,11,2,,,,,2,
55,3/1/2014,927,28,Inbound,4200423,4200526,Blue Hill Ave @ Morton St,13,11,2,,,,,2,
55,3/1/2014,932,28,Inbound,4200423,4200526,Blue Hill Ave @ Talbot Ave,19,11,8,,,,,8,
55,3/1/2014,935,28,Inbound,4200423,4200526,Blue Hill Ave @ Ellington St - Franklin Park Zoo,20,11,9,,,,,9,
55,3/1/2014,941,28,Inbound,4200423,4200526,Warren St @ Sunderland St,18,11,7,,,,,7,
55,3/1/2014,943,28,Inbound,4200423,4200526,Warren St @ Quincy St,19,11,8,,,,,8,
55,3/1/2014,947,28,Inbound,4200423,4200526,Warren St @ Moreland St,19,11,8,,,,,8,
55,3/1/2014,949,28,Inbound,4200423,4200526,Dudley Station,18,11,7,,,,,7,
55,3/1/2014,952,28,Inbound,4200423,4200526,Malcolm X Blvd @ Tremont St,16,11,5,,,,,5,
55,3/1/2014,954,28,Inbound,4200423,4200526,Ruggles Sta - Upper Level,18,11,7,,,,,7,
56,3/1/2014,931,28,Inbound,4200526,4200565,Mattapan Station - South Busway,2,11,-9,,,,,9,
56,3/1/2014,935,28,Inbound,4200526,4200565,Blue Hill Ave @ Fessenden St,9,11,-2,,,,,2,
56,3/1/2014,938,28,Inbound,4200526,4200565,Blue Hill Ave @ Morton St,9,11,-2,,,,,2,
56,3/1/2014,943,28,Inbound,4200526,4200565,Blue Hill Ave @ Talbot Ave,8,11,-3,,,,,3,
56,3/1/2014,946,28,Inbound,4200526,4200565,Blue Hill Ave @ Ellington St - Franklin Park Zoo,6,11,-5,,,,,5,
56,3/1/2014,952,28,Inbound,4200526,4200565,Warren St @ Sunderland St,8,11,-3,,,,,3,
56,3/1/2014,954,28,Inbound,4200526,4200565,Warren St @ Quincy St,7,11,-4,,,,,4,
56,3/1/2014,958,28,Inbound,4200526,4200565,Warren St @ Moreland St,7,11,-4,,,,,4,
56,3/1/2014,960,28,Inbound,4200526,4200565,Dudley Station,9,11,-2,,,,,2,
56,3/1/2014,963,28,Inbound,4200526,4200565,Malcolm X Blvd @ Tremont St,10,11,-1,,,,,1,
56,3/1/2014,965,28,Inbound,4200526,4200565,Ruggles Sta - Upper Level,8,11,-3,,,,,3,
57,3/1/2014,942,28,Inbound,4200565,4199602,Mattapan Station - South Busway,12,11,1,,,,,1,
57,3/1/2014,946,28,Inbound,4200565,4199602,Blue Hill Ave @ Fessenden St,15,11,4,,,,,4,
57,3/1/2014,949,28,Inbound,4200565,4199602,Blue Hill Ave @ Morton St,15,11,4,,,,,4,
57,3/1/2014,954,28,Inbound,4200565,4199602,Blue Hill Ave @ Talbot Ave,15,11,4,,,,,4,
57,3/1/2014,957,28,Inbound,4200565,4199602,Blue Hill Ave @ Ellington St - Franklin Park Zoo,17,11,6,,,,,6,
57,3/1/2014,963,28,Inbound,4200565,4199602,Warren St @ Sunderland St,14,11,3,,,,,3,
57,3/1/2014,965,28,Inbound,4200565,4199602,Warren St @ Quincy St,15,11,4,,,,,4,
57,3/1/2014,969,28,Inbound,4200565,4199602,Warren St @ Moreland St,15,11,4,,,,,4,
57,3/1/2014,971,28,Inbound,4200565,4199602,Dudley Station,13,11,2,,,,,2,
57,3/1/2014,974,28,Inbound,4200565,4199602,Malcolm X Blvd @ Tremont St,12,11,1,,,,,1,
57,3/1/2014,976,28,Inbound,4200565,4199602,Ruggles Sta - Upper Level,12,11,1,,,,,1,
58,3/1/2014,953,28,Inbound,4199602,4199629,Mattapan Station - South Busway,13,11,2,,,,,2,
58,3/1/2014,957,28,Inbound,4199602,4199629,Blue Hill Ave @ Fessenden St,8,11,-3,,,,,3,
58,3/1/2014,960,28,Inbound,4199602,4199629,Blue Hill Ave @ Morton St,8,11,-3,,,,,3,
58,3/1/2014,965,28,Inbound,4199602,4199629,Blue Hill Ave @ Talbot Ave,5,11,-6,,,,,6,
58,3/1/2014,968,28,Inbound,4199602,4199629,Blue Hill Ave @ Ellington St - Franklin Park Zoo,4,11,-7,,,,,7,
58,3/1/2014,974,28,Inbound,4199602,4199629,Warren St @ Sunderland St,4,11,-7,,,,,7,
58,3/1/2014,976,28,Inbound,4199602,4199629,Warren St @ Quincy St,3,11,-8,,,,,8,
58,3/1/2014,980,28,Inbound,4199602,4199629,Warren St @ Moreland St,1,11,-10,,,,,10,
58,3/1/2014,982,28,Inbound,4199602,4199629,Dudley Station,1,11,-10,,,,,10,
58,3/1/2014,985,28,Inbound,4199602,4199629,Malcolm X Blvd @ Tremont St,1,11,-10,,,,,10,
58,3/1/2014,987,28,Inbound,4199602,4199629,Ruggles Sta - Upper Level,0,11,-11,,,,,11,
59,3/1/2014,964,28,Inbound,4199629,4199810,Mattapan Station - South Busway,27,11,16,,,,,16,
59,3/1/2014,968,28,Inbound,4199629,4199810,Blue Hill Ave @ Fessenden St,12,11,1,,,,,1,
59,3/1/2014,971,28,Inbound,4199629,4199810,Blue Hill Ave @ Morton St,13,11,2,,,,,2,
59,3/1/2014,976,28,Inbound,4199629,4199810,Blue Hill Ave @ Talbot Ave,13,11,2,,,,,2,
59,3/1/2014,979,28,Inbound,4199629,4199810,Blue Hill Ave @ Ellington St - Franklin Park Zoo,13,11,2,,,,,2,
59,3/1/2014,985,28,Inbound,4199629,4199810,Warren St @ Sunderland St,15,11,4,,,,,4,
59,3/1/2014,987,28,Inbound,4199629,4199810,Warren St @ Quincy St,15,11,4,,,,,4,
59,3/1/2014,991,28,Inbound,4199629,4199810,Warren St @ Moreland St,17,11,6,,,,,6,
59,3/1/2014,993,28,Inbound,4199629,4199810,Dudley Station,17,11,6,,,,,6,
59,3/1/2014,996,28,Inbound,4199629,4199810,Malcolm X Blvd @ Tremont St,19,11,8,,,,,8,
59,3/1/2014,998,28,Inbound,4199629,4199810,Ruggles Sta - Upper Level,20,11,9,,,,,9,
60,3/1/2014,975,28,Inbound,4199810,4199667,Mattapan Station - South Busway,2,11,-9,,,,,9,
60,3/1/2014,979,28,Inbound,4199810,4199667,Blue Hill Ave @ Fessenden St,12,11,1,,,,,1,
60,3/1/2014,982,28,Inbound,4199810,4199667,Blue Hill Ave @ Morton St,11,11,0,,,,,0,
60,3/1/2014,987,28,Inbound,4199810,4199667,Blue Hill Ave @ Talbot Ave,13,11,2,,,,,2,
60,3/1/2014,990,28,Inbound,4199810,4199667,Blue Hill Ave @ Ellington St - Franklin Park Zoo,13,11,2,,,,,2,
60,3/1/2014,996,28,Inbound,4199810,4199667,Warren St @ Sunderland St,12,11,1,,,,,1,
60,3/1/2014,998,28,Inbound,4199810,4199667,Warren St @ Quincy St,13,11,2,,,,,2,
60,3/1/2014,1002,28,Inbound,4199810,4199667,Warren St @ Moreland St,11,11,0,,,,,0,
60,3/1/2014,1004,28,Inbound,4199810,4199667,Dudley Station,12,11,1,,,,,1,
60,3/1/2014,1007,28,Inbound,4199810,4199667,Malcolm X Blvd @ Tremont St,9,11,-2,,,,,2,
60,3/1/2014,1009,28,Inbound,4199810,4199667,Ruggles Sta - Upper Level,10,11,-1,,,,,1,
61,3/1/2014,986,28,Inbound,4199667,4199907,Mattapan Station - South Busway,4,11,-7,,,,,7,
61,3/1/2014,990,28,Inbound,4199667,4199907,Blue Hill Ave @ Fessenden St,12,11,1,,,,,1,
61,3/1/2014,993,28,Inbound,4199667,4199907,Blue Hill Ave @ Morton St,12,11,1,,,,,1,
61,3/1/2014,998,28,Inbound,4199667,4199907,Blue Hill Ave @ Talbot Ave,11,11,0,,,,,0,
61,3/1/2014,1001,28,Inbound,4199667,4199907,Blue Hill Ave @ Ellington St - Franklin Park Zoo,10,11,-1,,,,,1,
61,3/1/2014,1007,28,Inbound,4199667,4199907,Warren St @ Sunderland St,12,11,1,,,,,1,
61,3/1/2014,1009,28,Inbound,4199667,4199907,Warren St @ Quincy St,12,11,1,,,,,1,
61,3/1/2014,1013,28,Inbound,4199667,4199907,Warren St @ Moreland St,14,11,3,,,,,3,
61,3/1/2014,1015,28,Inbound,4199667,4199907,Dudley Station,13,11,2,,,,,2,
61,3/1/2014,1018,28,Inbound,4199667,4199907,Malcolm X Blvd @ Tremont St,14,11,3,,,,,3,
61,3/1/2014,1020,28,Inbound,4199667,4199907,Ruggles Sta - Upper Level,12,11,1,,,,,1,
62,3/1/2014,997,28,Inbound,4199907,4199743,Mattapan Station - South Busway,24,11,13,,,,,13,
62,3/1/2014,1001,28,Inbound,4199907,4199743,Blue Hill Ave @ Fessenden St,8,11,-3,,,,,3,
62,3/1/2014,1004,28,Inbound,4199907,4199743,Blue Hill Ave @ Morton St,8,11,-3,,,,,3,
62,3/1/2014,1009,28,Inbound,4199907,4199743,Blue Hill Ave @ Talbot Ave,8,11,-3,,,,,3,
62,3/1/2014,1012,28,Inbound,4199907,4199743,Blue Hill Ave @ Ellington St - Franklin Park Zoo,12,11,1,,,,,1,
62,3/1/2014,1018,28,Inbound,4199907,4199743,Warren St @ Sunderland St,9,11,-2,,,,,2,
62,3/1/2014,1020,28,Inbound,4199907,4199743,Warren St @ Quincy St,9,11,-2,,,,,2,
62,3/1/2014,1024,28,Inbound,4199907,4199743,Warren St @ Moreland St,9,11,-2,,,,,2,
62,3/1/2014,1026,28,Inbound,4199907,4199743,Dudley Station,9,11,-2,,,,,2,
62,3/1/2014,1029,28,Inbound,4199907,4199743,Malcolm X Blvd @ Tremont St,9,11,-2,,,,,2,
62,3/1/2014,1031,28,Inbound,4199907,4199743,Ruggles Sta - Upper Level,10,11,-1,,,,,1,
63,3/1/2014,1008,28,Inbound,4199743,4199775,Mattapan Station - South Busway,4,11,-7,,,,,7,
63,3/1/2014,1012,28,Inbound,4199743,4199775,Blue Hill Ave @ Fessenden St,18,11,7,,,,,7,
63,3/1/2014,1015,28,Inbound,4199743,4199775,Blue Hill Ave @ Morton St,18,11,7,,,,,7,
63,3/1/2014,1020,28,Inbound,4199743,4199775,Blue Hill Ave @ Talbot Ave,18,11,7,,,,,7,
63,3/1/2014,1023,28,Inbound,4199743,4199775,Blue Hill Ave @ Ellington St - Franklin Park Zoo,15,11,4,,,,,4,
63,3/1/2014,1029,28,Inbound,4199743,4199775,Warren St @ Sunderland St,16,11,5,,,,,5,
63,3/1/2014,1031,28,Inbound,4199743,4199775,Warren St @ Quincy St,17,11,6,,,,,6,
63,3/1/2014,1035,28,Inbound,4199743,4199775,Warren St @ Moreland St,18,11,7,,,,,7,
63,3/1/2014,1037,28,Inbound,4199743,4199775,Dudley Station,18,11,7,,,,,7,
63,3/1/2014,1040,28,Inbound,4199743,4199775,Malcolm X Blvd @ Tremont St,20,10,10,,,,,10,
63,3/1/2014,1042,28,Inbound,4199743,4199775,Ruggles Sta - Upper Level,20,12,8,,,,,8,
64,3/1/2014,1019,28,Inbound,4199775,4200425,Mattapan Station - South Busway,10,11,-1,,,,,1,
64,3/1/2014,1023,28,Inbound,4199775,4200425,Blue Hill Ave @ Fessenden St,6,11,-5,,,,,5,
64,3/1/2014,1026,28,Inbound,4199775,4200425,Blue Hill Ave @ Morton St,6,11,-5,,,,,5,
64,3/1/2014,1031,28,Inbound,4199775,4200425,Blue Hill Ave @ Talbot Ave,2,11,-9,,,,,9,
64,3/1/2014,1034,28,Inbound,4199775,4200425,Blue Hill Ave @ Ellington St - Franklin Park Zoo,2,11,-9,,,,,9,
64,3/1/2014,1040,28,Inbound,4199775,4200425,Warren St @ Sunderland St,2,10,-8,,,,,8,
64,3/1/2014,1042,28,Inbound,4199775,4200425,Warren St @ Quincy St,0,10,-10,,,,,10,
64,3/1/2014,1046,28,Inbound,4199775,4200425,Warren St @ Moreland St,-2,12,-14,,,,,14,
64,3/1/2014,1048,28,Inbound,4199775,4200425,Dudley Station,-1,15,-16,,,,,16,
64,3/1/2014,1050,28,Inbound,4199775,4200425,Malcolm X Blvd @ Tremont St,-2,14,-16,,,,,16,
64,3/1/2014,1054,28,Inbound,4199775,4200425,Ruggles Sta - Upper Level,-2,14,-16,,,,,16,
65,3/1/2014,1030,28,Inbound,4200425,4200528,Mattapan Station - South Busway,14,11,3,,,,,3,
65,3/1/2014,1034,28,Inbound,4200425,4200528,Blue Hill Ave @ Fessenden St,12,11,1,,,,,1,
65,3/1/2014,1037,28,Inbound,4200425,4200528,Blue Hill Ave @ Morton St,13,11,2,,,,,2,
65,3/1/2014,1042,28,Inbound,4200425,4200528,Blue Hill Ave @ Talbot Ave,14,11,3,,,,,3,
65,3/1/2014,1045,28,Inbound,4200425,4200528,Blue Hill Ave @ Ellington St - Franklin Park Zoo,14,11,3,,,,,3,
65,3/1/2014,1050,28,Inbound,4200425,4200528,Warren St @ Sunderland St,13,10,3,,,,,3,
65,3/1/2014,1052,28,Inbound,4200425,4200528,Warren St @ Quincy St,14,10,4,,,,,4,
65,3/1/2014,1058,28,Inbound,4200425,4200528,Warren St @ Moreland St,17,10,7,,,,,7,
65,3/1/2014,1063,28,Inbound,4200425,4200528,Dudley Station,16,10,6,,,,,6,
65,3/1/2014,1064,28,Inbound,4200425,4200528,Malcolm X Blvd @ Tremont St,14,10,4,,,,,4,
65,3/1/2014,1068,28,Inbound,4200425,4200528,Ruggles Sta - Upper Level,14,10,4,,,,,4,
66,3/1/2014,1041,28,Inbound,4200528,4200567,Mattapan Station - South Busway,2,11,-9,,,,,9,
66,3/1/2014,1045,28,Inbound,4200528,4200567,Blue Hill Ave @ Fessenden St,9,10,-1,,,,,1,
66,3/1/2014,1048,28,Inbound,4200528,4200567,Blue Hill Ave @ Morton St,8,10,-2,,,,,2,
66,3/1/2014,1053,28,Inbound,4200528,4200567,Blue Hill Ave @ Talbot Ave,12,10,2,,,,,2,
66,3/1/2014,1056,28,Inbound,4200528,4200567,Blue Hill Ave @ Ellington St - Franklin Park Zoo,12,10,2,,,,,2,
66,3/1/2014,1060,28,Inbound,4200528,4200567,Warren St @ Sunderland St,13,10,3,,,,,3,
66,3/1/2014,1062,28,Inbound,4200528,4200567,Warren St @ Quincy St,11,10,1,,,,,1,
66,3/1/2014,1068,28,Inbound,4200528,4200567,Warren St @ Moreland St,8,10,-2,,,,,2,
66,3/1/2014,1073,28,Inbound,4200528,4200567,Dudley Station,8,7,1,,,,,1,
66,3/1/2014,1074,28,Inbound,4200528,4200567,Malcolm X Blvd @ Tremont St,8,9,-1,,,,,1,
66,3/1/2014,1078,28,Inbound,4200528,4200567,Ruggles Sta - Upper Level,8,8,0,,,,,0,
67,3/1/2014,1052,28,Inbound,4200567,4199604,Mattapan Station - South Busway,11,11,0,,,,,0,
67,3/1/2014,1055,28,Inbound,4200567,4199604,Blue Hill Ave @ Fessenden St,13,11,2,,,,,2,
67,3/1/2014,1058,28,Inbound,4200567,4199604,Blue Hill Ave @ Morton St,15,11,4,,,,,4,
67,3/1/2014,1063,28,Inbound,4200567,4199604,Blue Hill Ave @ Talbot Ave,18,11,7,,,,,7,
67,3/1/2014,1066,28,Inbound,4200567,4199604,Blue Hill Ave @ Ellington St - Franklin Park Zoo,20,11,9,,,,,9,
67,3/1/2014,1070,28,Inbound,4200567,4199604,Warren St @ Sunderland St,20,11,9,,,,,9,
67,3/1/2014,1072,28,Inbound,4200567,4199604,Warren St @ Quincy St,22,12,10,,,,,10,
67,3/1/2014,1078,28,Inbound,4200567,4199604,Warren St @ Moreland St,24,10,14,,,,,14,
67,3/1/2014,1080,28,Inbound,4200567,4199604,Dudley Station,24,9,15,,,,,15,
67,3/1/2014,1083,28,Inbound,4200567,4199604,Malcolm X Blvd @ Tremont St,26,9,17,,,,,17,
67,3/1/2014,1086,28,Inbound,4200567,4199604,Ruggles Sta - Upper Level,25,9,16,,,,,16,
68,3/1/2014,1063,28,Inbound,4199604,4199631,Mattapan Station - South Busway,14,11,3,,,,,3,
68,3/1/2014,1066,28,Inbound,4199604,4199631,Blue Hill Ave @ Fessenden St,13,11,2,,,,,2,
68,3/1/2014,1069,28,Inbound,4199604,4199631,Blue Hill Ave @ Morton St,11,11,0,,,,,0,
68,3/1/2014,1074,28,Inbound,4199604,4199631,Blue Hill Ave @ Talbot Ave,8,11,-3,,,,,3,
68,3/1/2014,1077,28,Inbound,4199604,4199631,Blue Hill Ave @ Ellington St - Franklin Park Zoo,7,12,-5,,,,,5,
68,3/1/2014,1081,28,Inbound,4199604,4199631,Warren St @ Sunderland St,7,12,-5,,,,,5,
68,3/1/2014,1084,28,Inbound,4199604,4199631,Warren St @ Quincy St,6,12,-6,,,,,6,
68,3/1/2014,1088,28,Inbound,4199604,4199631,Warren St @ Moreland St,5,12,-7,,,,,7,
68,3/1/2014,1089,28,Inbound,4199604,4199631,Dudley Station,6,12,-6,,,,,6,
68,3/1/2014,1092,28,Inbound,4199604,4199631,Malcolm X Blvd @ Tremont St,6,12,-6,,,,,6,
68,3/1/2014,1095,28,Inbound,4199604,4199631,Ruggles Sta - Upper Level,9,12,-3,,,,,3,
69,3/1/2014,1074,28,Inbound,4199631,4199669,Mattapan Station - South Busway,25,13,12,,,,,12,
69,3/1/2014,1077,28,Inbound,4199631,4199669,Blue Hill Ave @ Fessenden St,7,13,-6,,,,,6,
69,3/1/2014,1080,28,Inbound,4199631,4199669,Blue Hill Ave @ Morton St,7,13,-6,,,,,6,
69,3/1/2014,1085,28,Inbound,4199631,4199669,Blue Hill Ave @ Talbot Ave,3,13,-10,,,,,10,
69,3/1/2014,1089,28,Inbound,4199631,4199669,Blue Hill Ave @ Ellington St - Franklin Park Zoo,2,13,-11,,,,,11,
69,3/1/2014,1093,28,Inbound,4199631,4199669,Warren St @ Sunderland St,2,13,-11,,,,,11,
69,3/1/2014,1096,28,Inbound,4199631,4199669,Warren St @ Quincy St,2,13,-11,,,,,11,
69,3/1/2014,1100,28,Inbound,4199631,4199669,Warren St @ Moreland St,0,13,-13,,,,,13,
69,3/1/2014,1101,28,Inbound,4199631,4199669,Dudley Station,-1,13,-14,,,,,14,
69,3/1/2014,1104,28,Inbound,4199631,4199669,Malcolm X Blvd @ Tremont St,-1,13,-14,,,,,14,
69,3/1/2014,1107,28,Inbound,4199631,4199669,Ruggles Sta - Upper Level,-4,13,-17,,,,,17,
70,3/1/2014,1087,28,Inbound,4199669,4199909,Mattapan Station - South Busway,6,13,-7,,,,,7,
70,3/1/2014,1090,28,Inbound,4199669,4199909,Blue Hill Ave @ Fessenden St,18,13,5,,,,,5,
70,3/1/2014,1093,28,Inbound,4199669,4199909,Blue Hill Ave @ Morton St,19,13,6,,,,,6,
70,3/1/2014,1098,28,Inbound,4199669,4199909,Blue Hill Ave @ Talbot Ave,22,13,9,,,,,9,
70,3/1/2014,1102,28,Inbound,4199669,4199909,Blue Hill Ave @ Ellington St - Franklin Park Zoo,23,13,10,,,,,10,
70,3/1/2014,1106,28,Inbound,4199669,4199909,Warren St @ Sunderland St,24,13,11,,,,,11,
70,3/1/2014,1109,28,Inbound,4199669,4199909,Warren St @ Quincy St,24,13,11,,,,,11,
70,3/1/2014,1113,28,Inbound,4199669,4199909,Warren St @ Moreland St,26,13,13,,,,,13,
70,3/1/2014,1114,28,Inbound,4199669,4199909,Dudley Station,27,13,14,,,,,14,
70,3/1/2014,1117,28,Inbound,4199669,4199909,Malcolm X Blvd @ Tremont St,26,13,13,,,,,13,
70,3/1/2014,1120,28,Inbound,4199669,4199909,Ruggles Sta - Upper Level,26,13,13,,,,,13,
71,3/1/2014,1100,28,Inbound,4199909,4199745,Mattapan Station - South Busway,18,13,5,,,,,5,
71,3/1/2014,1103,28,Inbound,4199909,4199745,Blue Hill Ave @ Fessenden St,10,13,-3,,,,,3,
71,3/1/2014,1106,28,Inbound,4199909,4199745,Blue Hill Ave @ Morton St,8,13,-5,,,,,5,
71,3/1/2014,1111,28,Inbound,4199909,4199745,Blue Hill Ave @ Talbot Ave,4,13,-9,,,,,9,
71,3/1/2014,1115,28,Inbound,4199909,4199745,Blue Hill Ave @ Ellington St - Franklin Park Zoo,3,13,-10,,,,,10,
71,3/1/2014,1119,28,Inbound,4199909,4199745,Warren St @ Sunderland St,0,13,-13,,,,,13,
71,3/1/2014,1122,28,Inbound,4199909,4199745,Warren St @ Quincy St,0,13,-13,,,,,13,
71,3/1/2014,1126,28,Inbound,4199909,4199745,Warren St @ Moreland St,-1,13,-14,,,,,14,
71,3/1/2014,1127,28,Inbound,4199909,4199745,Dudley Station,-2,15,-17,,,,,17,
71,3/1/2014,1130,28,Inbound,4199909,4199745,Malcolm X Blvd @ Tremont St,-4,14,-18,,,,,18,
71,3/1/2014,1133,28,Inbound,4199909,4199745,Ruggles Sta - Upper Level,-4,14,-18,,,,,18,
72,3/1/2014,1113,28,Inbound,4199745,4199777,Mattapan Station - South Busway,10,13,-3,,,,,3,
72,3/1/2014,1116,28,Inbound,4199745,4199777,Blue Hill Ave @ Fessenden St,14,13,1,,,,,1,
72,3/1/2014,1119,28,Inbound,4199745,4199777,Blue Hill Ave @ Morton St,15,13,2,,,,,2,
72,3/1/2014,1124,28,Inbound,4199745,4199777,Blue Hill Ave @ Talbot Ave,21,13,8,,,,,8,
72,3/1/2014,1128,28,Inbound,4199745,4199777,Blue Hill Ave @ Ellington St - Franklin Park Zoo,21,13,8,,,,,8,
72,3/1/2014,1132,28,Inbound,4199745,4199777,Warren St @ Sunderland St,24,13,11,,,,,11,
72,3/1/2014,1135,28,Inbound,4199745,4199777,Warren St @ Quincy St,24,12,12,,,,,12,
72,3/1/2014,1139,28,Inbound,4199745,4199777,Warren St @ Moreland St,24,11,13,,,,,13,
72,3/1/2014,1142,28,Inbound,4199745,4199777,Dudley Station,25,11,14,,,,,14,
72,3/1/2014,1144,28,Inbound,4199745,4199777,Malcolm X Blvd @ Tremont St,27,11,16,,,,,16,
72,3/1/2014,1147,28,Inbound,4199745,4199777,Ruggles Sta - Upper Level,28,11,17,,,,,17,
73,3/1/2014,1126,28,Inbound,4199777,4200427,Mattapan Station - South Busway,2,13,-11,,,,,11,
73,3/1/2014,1129,28,Inbound,4199777,4200427,Blue Hill Ave @ Fessenden St,11,13,-2,,,,,2,
73,3/1/2014,1132,28,Inbound,4199777,4200427,Blue Hill Ave @ Morton St,11,12,-1,,,,,1,
73,3/1/2014,1137,28,Inbound,4199777,4200427,Blue Hill Ave @ Talbot Ave,7,12,-5,,,,,5,
73,3/1/2014,1141,28,Inbound,4199777,4200427,Blue Hill Ave @ Ellington St - Franklin Park Zoo,7,11,-4,,,,,4,
73,3/1/2014,1145,28,Inbound,4199777,4200427,Warren St @ Sunderland St,7,11,-4,,,,,4,
73,3/1/2014,1147,28,Inbound,4199777,4200427,Warren St @ Quincy St,7,11,-4,,,,,4,
73,3/1/2014,1150,28,Inbound,4199777,4200427,Warren St @ Moreland St,7,11,-4,,,,,4,
73,3/1/2014,1153,28,Inbound,4199777,4200427,Dudley Station,6,11,-5,,,,,5,
73,3/1/2014,1155,28,Inbound,4199777,4200427,Malcolm X Blvd @ Tremont St,5,11,-6,,,,,6,
73,3/1/2014,1158,28,Inbound,4199777,4200427,Ruggles Sta - Upper Level,4,11,-7,,,,,7,
74,3/1/2014,1139,28,Inbound,4200427,4200530,Mattapan Station - South Busway,20,13,7,,,,,7,
74,3/1/2014,1142,28,Inbound,4200427,4200530,Blue Hill Ave @ Fessenden St,20,13,7,,,,,7,
74,3/1/2014,1144,28,Inbound,4200427,4200530,Blue Hill Ave @ Morton St,21,13,8,,,,,8,
74,3/1/2014,1149,28,Inbound,4200427,4200530,Blue Hill Ave @ Talbot Ave,22,13,9,,,,,9,
74,3/1/2014,1152,28,Inbound,4200427,4200530,Blue Hill Ave @ Ellington St - Franklin Park Zoo,22,13,9,,,,,9,
74,3/1/2014,1156,28,Inbound,4200427,4200530,Warren St @ Sunderland St,22,13,9,,,,,9,
74,3/1/2014,1158,28,Inbound,4200427,4200530,Warren St @ Quincy St,22,13,9,,,,,9,
74,3/1/2014,1161,28,Inbound,4200427,4200530,Warren St @ Moreland St,21,13,8,,,,,8,
74,3/1/2014,1164,28,Inbound,4200427,4200530,Dudley Station,21,13,8,,,,,8,
74,3/1/2014,1166,28,Inbound,4200427,4200530,Malcolm X Blvd @ Tremont St,22,13,9,,,,,9,
74,3/1/2014,1169,28,Inbound,4200427,4200530,Ruggles Sta - Upper Level,29,13,16,,,,,16,
75,3/1/2014,1152,28,Inbound,4200530,4199606,Mattapan Station - South Busway,22,13,9,,,,,9,
75,3/1/2014,1155,28,Inbound,4200530,4199606,Blue Hill Ave @ Fessenden St,4,13,-9,,,,,9,
75,3/1/2014,1157,28,Inbound,4200530,4199606,Blue Hill Ave @ Morton St,2,13,-11,,,,,11,
75,3/1/2014,1162,28,Inbound,4200530,4199606,Blue Hill Ave @ Talbot Ave,0,13,-13,,,,,13,
75,3/1/2014,1165,28,Inbound,4200530,4199606,Blue Hill Ave @ Ellington St - Franklin Park Zoo,2,13,-11,,,,,11,
75,3/1/2014,1169,28,Inbound,4200530,4199606,Warren St @ Sunderland St,0,13,-13,,,,,13,
75,3/1/2014,1171,28,Inbound,4200530,4199606,Warren St @ Quincy St,0,13,-13,,,,,13,
75,3/1/2014,1174,28,Inbound,4200530,4199606,Warren St @ Moreland St,1,13,-12,,,,,12,
75,3/1/2014,1177,28,Inbound,4200530,4199606,Dudley Station,2,13,-11,,,,,11,
75,3/1/2014,1179,28,Inbound,4200530,4199606,Malcolm X Blvd @ Tremont St,0,13,-13,,,,,13,
75,3/1/2014,1182,28,Inbound,4200530,4199606,Ruggles Sta - Upper Level,-7,13,-20,,,,,20,
76,3/1/2014,1165,28,Inbound,4199606,4199671,Mattapan Station - South Busway,7,13,-6,,,,,6,
76,3/1/2014,1168,28,Inbound,4199606,4199671,Blue Hill Ave @ Fessenden St,13,13,0,,,,,0,
76,3/1/2014,1170,28,Inbound,4199606,4199671,Blue Hill Ave @ Morton St,14,13,1,,,,,1,
76,3/1/2014,1175,28,Inbound,4199606,4199671,Blue Hill Ave @ Talbot Ave,16,13,3,,,,,3,
76,3/1/2014,1178,28,Inbound,4199606,4199671,Blue Hill Ave @ Ellington St - Franklin Park Zoo,13,13,0,,,,,0,
76,3/1/2014,1182,28,Inbound,4199606,4199671,Warren St @ Sunderland St,15,13,2,,,,,2,
76,3/1/2014,1184,28,Inbound,4199606,4199671,Warren St @ Quincy St,15,13,2,,,,,2,
76,3/1/2014,1187,28,Inbound,4199606,4199671,Warren St @ Moreland St,15,13,2,,,,,2,
76,3/1/2014,1190,28,Inbound,4199606,4199671,Dudley Station,14,13,1,,,,,1,
76,3/1/2014,1192,28,Inbound,4199606,4199671,Malcolm X Blvd @ Tremont St,16,13,3,,,,,3,
76,3/1/2014,1195,28,Inbound,4199606,4199671,Ruggles Sta - Upper Level,16,13,3,,,,,3,
77,3/1/2014,1178,28,Inbound,4199671,4199911,Mattapan Station - South Busway,19,13,6,,,,,6,
77,3/1/2014,1181,28,Inbound,4199671,4199911,Blue Hill Ave @ Fessenden St,22,13,9,,,,,9,
77,3/1/2014,1183,28,Inbound,4199671,4199911,Blue Hill Ave @ Morton St,21,13,8,,,,,8,
77,3/1/2014,1188,28,Inbound,4199671,4199911,Blue Hill Ave @ Talbot Ave,19,13,6,,,,,6,
77,3/1/2014,1191,28,Inbound,4199671,4199911,Blue Hill Ave @ Ellington St - Franklin Park Zoo,20,13,7,,,,,7,
77,3/1/2014,1195,28,Inbound,4199671,4199911,Warren St @ Sunderland St,20,13,7,,,,,7,
77,3/1/2014,1197,28,Inbound,4199671,4199911,Warren St @ Quincy St,21,13,8,,,,,8,
77,3/1/2014,1200,28,Inbound,4199671,4199911,Warren St @ Moreland St,20,13,7,,,,,7,
77,3/1/2014,1203,28,Inbound,4199671,4199911,Dudley Station,20,13,7,,,,,7,
77,3/1/2014,1205,28,Inbound,4199671,4199911,Malcolm X Blvd @ Tremont St,20,13,7,,,,,7,
77,3/1/2014,1208,28,Inbound,4199671,4199911,Ruggles Sta - Upper Level,20,13,7,,,,,7,
78,3/1/2014,1191,28,Inbound,4199911,4199747,Mattapan Station - South Busway,6,17,-11,,,,,11,
78,3/1/2014,1194,28,Inbound,4199911,4199747,Blue Hill Ave @ Fessenden St,11,17,-6,,,,,6,
78,3/1/2014,1196,28,Inbound,4199911,4199747,Blue Hill Ave @ Morton St,12,17,-5,,,,,5,
78,3/1/2014,1201,28,Inbound,4199911,4199747,Blue Hill Ave @ Talbot Ave,14,17,-3,,,,,3,
78,3/1/2014,1204,28,Inbound,4199911,4199747,Blue Hill Ave @ Ellington St - Franklin Park Zoo,14,17,-3,,,,,3,
78,3/1/2014,1208,28,Inbound,4199911,4199747,Warren St @ Sunderland St,13,17,-4,,,,,4,
78,3/1/2014,1210,28,Inbound,4199911,4199747,Warren St @ Quincy St,12,17,-5,,,,,5,
78,3/1/2014,1213,28,Inbound,4199911,4199747,Warren St @ Moreland St,12,17,-5,,,,,5,
78,3/1/2014,1216,28,Inbound,4199911,4199747,Dudley Station,12,17,-5,,,,,5,
78,3/1/2014,1218,28,Inbound,4199911,4199747,Malcolm X Blvd @ Tremont St,12,17,-5,,,,,5,
78,3/1/2014,1221,28,Inbound,4199911,4199747,Ruggles Sta - Upper Level,12,17,-5,,,,,5,
79,3/1/2014,1208,28,Inbound,4199747,4199860,Mattapan Station - South Busway,16,17,-1,,,,,1,
79,3/1/2014,1211,28,Inbound,4199747,4199860,Blue Hill Ave @ Fessenden St,18,17,1,,,,,1,
79,3/1/2014,1213,28,Inbound,4199747,4199860,Blue Hill Ave @ Morton St,17,17,0,,,,,0,
79,3/1/2014,1218,28,Inbound,4199747,4199860,Blue Hill Ave @ Talbot Ave,17,17,0,,,,,0,
79,3/1/2014,1221,28,Inbound,4199747,4199860,Blue Hill Ave @ Ellington St - Franklin Park Zoo,18,17,1,,,,,1,
79,3/1/2014,1225,28,Inbound,4199747,4199860,Warren St @ Sunderland St,16,17,-1,,,,,1,
79,3/1/2014,1227,28,Inbound,4199747,4199860,Warren St @ Quincy St,18,17,1,,,,,1,
79,3/1/2014,1230,28,Inbound,4199747,4199860,Warren St @ Moreland St,19,17,2,,,,,2,
79,3/1/2014,1233,28,Inbound,4199747,4199860,Dudley Station,20,17,3,,,,,3,
79,3/1/2014,1235,28,Inbound,4199747,4199860,Malcolm X Blvd @ Tremont St,19,17,2,,,,,2,
79,3/1/2014,1238,28,Inbound,4199747,4199860,Ruggles Sta - Upper Level,20,17,3,,,,,3,
80,3/1/2014,1225,28,Inbound,4199860,4200429,Mattapan Station - South Busway,12,17,-5,,,,,5,
80,3/1/2014,1228,28,Inbound,4199860,4200429,Blue Hill Ave @ Fessenden St,16,17,-1,,,,,1,
80,3/1/2014,1230,28,Inbound,4199860,4200429,Blue Hill Ave @ Morton St,16,17,-1,,,,,1,
80,3/1/2014,1235,28,Inbound,4199860,4200429,Blue Hill Ave @ Talbot Ave,14,17,-3,,,,,3,
80,3/1/2014,1238,28,Inbound,4199860,4200429,Blue Hill Ave @ Ellington St - Franklin Park Zoo,12,17,-5,,,,,5,
80,3/1/2014,1242,28,Inbound,4199860,4200429,Warren St @ Sunderland St,13,17,-4,,,,,4,
80,3/1/2014,1244,28,Inbound,4199860,4200429,Warren St @ Quincy St,11,17,-6,,,,,6,
80,3/1/2014,1247,28,Inbound,4199860,4200429,Warren St @ Moreland St,11,17,-6,,,,,6,
80,3/1/2014,1250,28,Inbound,4199860,4200429,Dudley Station,10,17,-7,,,,,7,
80,3/1/2014,1252,28,Inbound,4199860,4200429,Malcolm X Blvd @ Tremont St,10,17,-7,,,,,7,
80,3/1/2014,1255,28,Inbound,4199860,4200429,Ruggles Sta - Upper Level,10,17,-7,,,,,7,
81,3/1/2014,1242,28,Inbound,4200429,4200532,Mattapan Station - South Busway,16,17,-1,,,,,1,
81,3/1/2014,1245,28,Inbound,4200429,4200532,Blue Hill Ave @ Fessenden St,15,17,-2,,,,,2,
81,3/1/2014,1247,28,Inbound,4200429,4200532,Blue Hill Ave @ Morton St,15,17,-2,,,,,2,
81,3/1/2014,1252,28,Inbound,4200429,4200532,Blue Hill Ave @ Talbot Ave,17,17,0,,,,,0,
81,3/1/2014,1255,28,Inbound,4200429,4200532,Blue Hill Ave @ Ellington St - Franklin Park Zoo,18,17,1,,,,,1,
81,3/1/2014,1259,28,Inbound,4200429,4200532,Warren St @ Sunderland St,18,17,1,,,,,1,
81,3/1/2014,1261,28,Inbound,4200429,4200532,Warren St @ Quincy St,19,17,2,,,,,2,
81,3/1/2014,1264,28,Inbound,4200429,4200532,Warren St @ Moreland St,20,17,3,,,,,3,
81,3/1/2014,1267,28,Inbound,4200429,4200532,Dudley Station,20,17,3,,,,,3,
81,3/1/2014,1269,28,Inbound,4200429,4200532,Malcolm X Blvd @ Tremont St,21,17,4,,,,,4,
81,3/1/2014,1272,28,Inbound,4200429,4200532,Ruggles Sta - Upper Level,20,17,3,,,,,3,
82,3/1/2014,1259,28,Inbound,4200532,4199932,Mattapan Station - South Busway,12,17,-5,,,,,5,
82,3/1/2014,1262,28,Inbound,4200532,4199932,Blue Hill Ave @ Fessenden St,20,17,3,,,,,3,
82,3/1/2014,1264,28,Inbound,4200532,4199932,Blue Hill Ave @ Morton St,20,17,3,,,,,3,
82,3/1/2014,1269,28,Inbound,4200532,4199932,Blue Hill Ave @ Talbot Ave,17,17,0,,,,,0,
82,3/1/2014,1272,28,Inbound,4200532,4199932,Blue Hill Ave @ Ellington St - Franklin Park Zoo,17,17,0,,,,,0,
82,3/1/2014,1276,28,Inbound,4200532,4199932,Warren St @ Sunderland St,18,17,1,,,,,1,
82,3/1/2014,1278,28,Inbound,4200532,4199932,Warren St @ Quincy St,19,17,2,,,,,2,
82,3/1/2014,1281,28,Inbound,4200532,4199932,Warren St @ Moreland St,18,17,1,,,,,1,
82,3/1/2014,1284,28,Inbound,4200532,4199932,Dudley Station,19,17,2,,,,,2,
82,3/1/2014,1286,28,Inbound,4200532,4199932,Malcolm X Blvd @ Tremont St,18,17,1,,,,,1,
82,3/1/2014,1289,28,Inbound,4200532,4199932,Ruggles Sta - Upper Level,18,17,1,,,,,1,
83,3/1/2014,1276,28,Inbound,4199932,4199962,Mattapan Station - South Busway,22,17,5,,,,,5,
83,3/1/2014,1279,28,Inbound,4199932,4199962,Blue Hill Ave @ Fessenden St,11,17,-6,,,,,6,
83,3/1/2014,1281,28,Inbound,4199932,4199962,Blue Hill Ave @ Morton St,12,17,-5,,,,,5,
83,3/1/2014,1286,28,Inbound,4199932,4199962,Blue Hill Ave @ Talbot Ave,14,17,-3,,,,,3,
83,3/1/2014,1289,28,Inbound,4199932,4199962,Blue Hill Ave @ Ellington St - Franklin Park Zoo,13,17,-4,,,,,4,
83,3/1/2014,1293,28,Inbound,4199932,4199962,Warren St @ Sunderland St,15,17,-2,,,,,2,
83,3/1/2014,1295,28,Inbound,4199932,4199962,Warren St @ Quincy St,14,17,-3,,,,,3,
83,3/1/2014,1298,28,Inbound,4199932,4199962,Warren St @ Moreland St,15,17,-2,,,,,2,
83,3/1/2014,1301,28,Inbound,4199932,4199962,Dudley Station,15,17,-2,,,,,2,
83,3/1/2014,1303,28,Inbound,4199932,4199962,Malcolm X Blvd @ Tremont St,15,17,-2,,,,,2,
83,3/1/2014,1306,28,Inbound,4199932,4199962,Ruggles Sta - Upper Level,16,18,-2,,,,,2,
84,3/1/2014,1293,28,Inbound,4199962,4200005,Mattapan Station - South Busway,25,17,8,,,,,8,
84,3/1/2014,1296,28,Inbound,4199962,4200005,Blue Hill Ave @ Fessenden St,24,17,7,,,,,7,
84,3/1/2014,1298,28,Inbound,4199962,4200005,Blue Hill Ave @ Morton St,24,17,7,,,,,7,
84,3/1/2014,1303,28,Inbound,4199962,4200005,Blue Hill Ave @ Talbot Ave,25,17,8,,,,,8,
84,3/1/2014,1306,28,Inbound,4199962,4200005,Blue Hill Ave @ Ellington St - Franklin Park Zoo,27,17,10,,,,,10,
84,3/1/2014,1310,28,Inbound,4199962,4200005,Warren St @ Sunderland St,24,16,8,,,,,8,
84,3/1/2014,1312,28,Inbound,4199962,4200005,Warren St @ Quincy St,22,16,6,,,,,6,
84,3/1/2014,1315,28,Inbound,4199962,4200005,Warren St @ Moreland St,21,16,5,,,,,5,
84,3/1/2014,1318,28,Inbound,4199962,4200005,Dudley Station,21,15,6,,,,,6,
84,3/1/2014,1320,28,Inbound,4199962,4200005,Malcolm X Blvd @ Tremont St,21,15,6,,,,,6,
84,3/1/2014,1324,28,Inbound,4199962,4200005,Ruggles Sta - Upper Level,22,15,7,,,,,7,
85,3/1/2014,1310,28,Inbound,4200005,4199862,Mattapan Station - South Busway,30,17,13,,,,,13,
85,3/1/2014,1313,28,Inbound,4200005,4199862,Blue Hill Ave @ Fessenden St,15,17,-2,,,,,2,
85,3/1/2014,1315,28,Inbound,4200005,4199862,Blue Hill Ave @ Morton St,15,17,-2,,,,,2,
85,3/1/2014,1320,28,Inbound,4200005,4199862,Blue Hill Ave @ Talbot Ave,13,16,-3,,,,,3,
85,3/1/2014,1323,28,Inbound,4200005,4199862,Blue Hill Ave @ Ellington St - Franklin Park Zoo,13,16,-3,,,,,3,
85,3/1/2014,1326,28,Inbound,4200005,4199862,Warren St @ Sunderland St,14,16,-2,,,,,2,
85,3/1/2014,1328,28,Inbound,4200005,4199862,Warren St @ Quincy St,15,16,-1,,,,,1,
85,3/1/2014,1331,28,Inbound,4200005,4199862,Warren St @ Moreland St,15,16,-1,,,,,1,
85,3/1/2014,1333,28,Inbound,4200005,4199862,Dudley Station,14,16,-2,,,,,2,
85,3/1/2014,1335,28,Inbound,4200005,4199862,Malcolm X Blvd @ Tremont St,15,16,-1,,,,,1,
85,3/1/2014,1339,28,Inbound,4200005,4199862,Ruggles Sta - Upper Level,14,16,-2,,,,,2,
86,3/1/2014,1327,28,Inbound,4199862,4200052,Mattapan Station - South Busway,19,17,2,,,,,2,
86,3/1/2014,1330,28,Inbound,4199862,4200052,Blue Hill Ave @ Fessenden St,20,17,3,,,,,3,
86,3/1/2014,1332,28,Inbound,4199862,4200052,Blue Hill Ave @ Morton St,19,17,2,,,,,2,
86,3/1/2014,1336,28,Inbound,4199862,4200052,Blue Hill Ave @ Talbot Ave,21,17,4,,,,,4,
86,3/1/2014,1339,28,Inbound,4199862,4200052,Blue Hill Ave @ Ellington St - Franklin Park Zoo,18,17,1,,,,,1,
86,3/1/2014,1342,28,Inbound,4199862,4200052,Warren St @ Sunderland St,19,17,2,,,,,2,
86,3/1/2014,1344,28,Inbound,4199862,4200052,Warren St @ Quincy St,19,17,2,,,,,2,
86,3/1/2014,1347,28,Inbound,4199862,4200052,Warren St @ Moreland St,19,17,2,,,,,2,
86,3/1/2014,1349,28,Inbound,4199862,4200052,Dudley Station,19,17,2,,,,,2,
86,3/1/2014,1351,28,Inbound,4199862,4200052,Malcolm X Blvd @ Tremont St,18,17,1,,,,,1,
86,3/1/2014,1355,28,Inbound,4199862,4200052,Ruggles Sta - Upper Level,18,17,1,,,,,1,
87,3/1/2014,1344,28,Inbound,4200052,4199934,Mattapan Station - South Busway,12,17,-5,,,,,5,
87,3/1/2014,1347,28,Inbound,4200052,4199934,Blue Hill Ave @ Fessenden St,13,17,-4,,,,,4,
87,3/1/2014,1349,28,Inbound,4200052,4199934,Blue Hill Ave @ Morton St,14,17,-3,,,,,3,
87,3/1/2014,1353,28,Inbound,4200052,4199934,Blue Hill Ave @ Talbot Ave,13,17,-4,,,,,4,
87,3/1/2014,1356,28,Inbound,4200052,4199934,Blue Hill Ave @ Ellington St - Franklin Park Zoo,14,17,-3,,,,,3,
87,3/1/2014,1359,28,Inbound,4200052,4199934,Warren St @ Sunderland St,11,17,-6,,,,,6,
87,3/1/2014,1361,28,Inbound,4200052,4199934,Warren St @ Quincy St,11,17,-6,,,,,6,
87,3/1/2014,1364,28,Inbound,4200052,4199934,Warren St @ Moreland St,10,17,-7,,,,,7,
87,3/1/2014,1366,28,Inbound,4200052,4199934,Dudley Station,10,17,-7,,,,,7,
87,3/1/2014,1368,28,Inbound,4200052,4199934,Malcolm X Blvd @ Tremont St,10,17,-7,,,,,7,
87,3/1/2014,1372,28,Inbound,4200052,4199934,Ruggles Sta - Upper Level,10,17,-7,,,,,7,
88,3/1/2014,1361,28,Inbound,4199934,4199964,Mattapan Station - South Busway,19,17,2,,,,,2,
88,3/1/2014,1364,28,Inbound,4199934,4199964,Blue Hill Ave @ Fessenden St,15,17,-2,,,,,2,
88,3/1/2014,1366,28,Inbound,4199934,4199964,Blue Hill Ave @ Morton St,14,17,-3,,,,,3,
88,3/1/2014,1370,28,Inbound,4199934,4199964,Blue Hill Ave @ Talbot Ave,13,17,-4,,,,,4,
88,3/1/2014,1373,28,Inbound,4199934,4199964,Blue Hill Ave @ Ellington St - Franklin Park Zoo,13,17,-4,,,,,4,
88,3/1/2014,1376,28,Inbound,4199934,4199964,Warren St @ Sunderland St,15,17,-2,,,,,2,
88,3/1/2014,1378,28,Inbound,4199934,4199964,Warren St @ Quincy St,15,17,-2,,,,,2,
88,3/1/2014,1381,28,Inbound,4199934,4199964,Warren St @ Moreland St,15,17,-2,,,,,2,
88,3/1/2014,1383,28,Inbound,4199934,4199964,Dudley Station,15,17,-2,,,,,2,
88,3/1/2014,1385,28,Inbound,4199934,4199964,Malcolm X Blvd @ Tremont St,15,17,-2,,,,,2,
88,3/1/2014,1389,28,Inbound,4199934,4199964,Ruggles Sta - Upper Level,14,17,-3,,,,,3,
89,3/1/2014,1378,28,Inbound,4199964,4200007,Mattapan Station - South Busway,17,17,0,,,,,0,
89,3/1/2014,1381,28,Inbound,4199964,4200007,Blue Hill Ave @ Fessenden St,18,17,1,,,,,1,
89,3/1/2014,1383,28,Inbound,4199964,4200007,Blue Hill Ave @ Morton St,18,17,1,,,,,1,
89,3/1/2014,1387,28,Inbound,4199964,4200007,Blue Hill Ave @ Talbot Ave,20,17,3,,,,,3,
89,3/1/2014,1390,28,Inbound,4199964,4200007,Blue Hill Ave @ Ellington St - Franklin Park Zoo,20,17,3,,,,,3,
89,3/1/2014,1393,28,Inbound,4199964,4200007,Warren St @ Sunderland St,19,17,2,,,,,2,
89,3/1/2014,1395,28,Inbound,4199964,4200007,Warren St @ Quincy St,18,15,3,,,,,3,
89,3/1/2014,1398,28,Inbound,4199964,4200007,Warren St @ Moreland St,20,15,5,,,,,5,
89,3/1/2014,1400,28,Inbound,4199964,4200007,Dudley Station,20,15,5,,,,,5,
89,3/1/2014,1402,28,Inbound,4199964,4200007,Malcolm X Blvd @ Tremont St,20,14,6,,,,,6,
89,3/1/2014,1406,28,Inbound,4199964,4200007,Ruggles Sta - Upper Level,20,14,6,,,,,6,
90,3/1/2014,1395,28,Inbound,4200007,4200082,Mattapan Station - South Busway,14,17,-3,,,,,3,
90,3/1/2014,1398,28,Inbound,4200007,4200082,Blue Hill Ave @ Fessenden St,14,16,-2,,,,,2,
90,3/1/2014,1400,28,Inbound,4200007,4200082,Blue Hill Ave @ Morton St,14,16,-2,,,,,2,
90,3/1/2014,1404,28,Inbound,4200007,4200082,Blue Hill Ave @ Talbot Ave,12,16,-4,,,,,4,
90,3/1/2014,1407,28,Inbound,4200007,4200082,Blue Hill Ave @ Ellington St - Franklin Park Zoo,13,15,-2,,,,,2,
90,3/1/2014,1410,28,Inbound,4200007,4200082,Warren St @ Quincy St,13,15,-2,,,,,2,
90,3/1/2014,1410,28,Inbound,4200007,4200082,Warren St @ Sunderland St,13,15,-2,,,,,2,
90,3/1/2014,1413,28,Inbound,4200007,4200082,Warren St @ Moreland St,11,15,-4,,,,,4,
90,3/1/2014,1415,28,Inbound,4200007,4200082,Dudley Station,11,15,-4,,,,,4,
90,3/1/2014,1416,28,Inbound,4200007,4200082,Malcolm X Blvd @ Tremont St,11,15,-4,,,,,4,
90,3/1/2014,1420,28,Inbound,4200007,4200082,Ruggles Sta - Upper Level,10,15,-5,,,,,5,
91,3/1/2014,1412,28,Inbound,4200082,4200054,Mattapan Station - South Busway,10,17,-7,,,,,7,
91,3/1/2014,1414,28,Inbound,4200082,4200054,Blue Hill Ave @ Fessenden St,20,17,3,,,,,3,
91,3/1/2014,1416,28,Inbound,4200082,4200054,Blue Hill Ave @ Morton St,20,17,3,,,,,3,
91,3/1/2014,1420,28,Inbound,4200082,4200054,Blue Hill Ave @ Talbot Ave,21,17,4,,,,,4,
91,3/1/2014,1422,28,Inbound,4200082,4200054,Blue Hill Ave @ Ellington St - Franklin Park Zoo,20,17,3,,,,,3,
91,3/1/2014,1425,28,Inbound,4200082,4200054,Warren St @ Quincy St,21,17,4,,,,,4,
91,3/1/2014,1425,28,Inbound,4200082,4200054,Warren St @ Sunderland St,20,17,3,,,,,3,
91,3/1/2014,1428,28,Inbound,4200082,4200054,Warren St @ Moreland St,21,17,4,,,,,4,
91,3/1/2014,1430,28,Inbound,4200082,4200054,Dudley Station,22,17,5,,,,,5,
91,3/1/2014,1431,28,Inbound,4200082,4200054,Malcolm X Blvd @ Tremont St,22,17,5,,,,,5,
91,3/1/2014,1435,28,Inbound,4200082,4200054,Ruggles Sta - Upper Level,23,17,6,,,,,6,
92,3/1/2014,1429,28,Inbound,4200054,4199936,Mattapan Station - South Busway,20,17,3,,,,,3,
92,3/1/2014,1431,28,Inbound,4200054,4199936,Blue Hill Ave @ Fessenden St,30,17,13,,,,,13,
92,3/1/2014,1433,28,Inbound,4200054,4199936,Blue Hill Ave @ Morton St,29,17,12,,,,,12,
92,3/1/2014,1437,28,Inbound,4200054,4199936,Blue Hill Ave @ Talbot Ave,30,17,13,,,,,13,
92,3/1/2014,1439,28,Inbound,4200054,4199936,Blue Hill Ave @ Ellington St - Franklin Park Zoo,30,17,13,,,,,13,
92,3/1/2014,1442,28,Inbound,4200054,4199936,Warren St @ Quincy St,27,17,10,,,,,10,
92,3/1/2014,1442,28,Inbound,4200054,4199936,Warren St @ Sunderland St,28,17,11,,,,,11,
92,3/1/2014,1445,28,Inbound,4200054,4199936,Warren St @ Moreland St,26,17,9,,,,,9,
92,3/1/2014,1447,28,Inbound,4200054,4199936,Dudley Station,25,17,8,,,,,8,
92,3/1/2014,1448,28,Inbound,4200054,4199936,Malcolm X Blvd @ Tremont St,25,17,8,,,,,8,
92,3/1/2014,1452,28,Inbound,4200054,4199936,Ruggles Sta - Upper Level,25,17,8,,,,,8,
93,3/1/2014,1446,28,Inbound,4199936,4199966,Mattapan Station - South Busway,8,17,-9,,,,,9,
93,3/1/2014,1448,28,Inbound,4199936,4199966,Blue Hill Ave @ Fessenden St,9,17,-8,,,,,8,
93,3/1/2014,1450,28,Inbound,4199936,4199966,Blue Hill Ave @ Morton St,10,17,-7,,,,,7,
93,3/1/2014,1454,28,Inbound,4199936,4199966,Blue Hill Ave @ Talbot Ave,8,17,-9,,,,,9,
93,3/1/2014,1456,28,Inbound,4199936,4199966,Blue Hill Ave @ Ellington St - Franklin Park Zoo,8,17,-9,,,,,9,
93,3/1/2014,1459,28,Inbound,4199936,4199966,Warren St @ Quincy St,11,17,-6,,,,,6,
93,3/1/2014,1459,28,Inbound,4199936,4199966,Warren St @ Sunderland St,10,17,-7,,,,,7,
93,3/1/2014,1462,28,Inbound,4199936,4199966,Warren St @ Moreland St,12,17,-5,,,,,5,
93,3/1/2014,1464,28,Inbound,4199936,4199966,Dudley Station,11,17,-6,,,,,6,
93,3/1/2014,1465,28,Inbound,4199936,4199966,Malcolm X Blvd @ Tremont St,11,17,-6,,,,,6,
93,3/1/2014,1469,28,Inbound,4199936,4199966,Ruggles Sta - Upper Level,11,17,-6,,,,,6,
94,3/1/2014,1463,28,Inbound,4199966,4200009,Mattapan Station - South Busway,24,17,7,,,,,7,
94,3/1/2014,1465,28,Inbound,4199966,4200009,Blue Hill Ave @ Fessenden St,11,17,-6,,,,,6,
94,3/1/2014,1467,28,Inbound,4199966,4200009,Blue Hill Ave @ Morton St,11,17,-6,,,,,6,
94,3/1/2014,1471,28,Inbound,4199966,4200009,Blue Hill Ave @ Talbot Ave,11,17,-6,,,,,6,
94,3/1/2014,1473,28,Inbound,4199966,4200009,Blue Hill Ave @ Ellington St - Franklin Park Zoo,11,17,-6,,,,,6,
94,3/1/2014,1476,28,Inbound,4199966,4200009,Warren St @ Quincy St,10,17,-7,,,,,7,
94,3/1/2014,1476,28,Inbound,4199966,4200009,Warren St @ Sunderland St,10,17,-7,,,,,7,
94,3/1/2014,1479,28,Inbound,4199966,4200009,Warren St @ Moreland St,8,17,-9,,,,,9,
94,3/1/2014,1481,28,Inbound,4199966,4200009,Dudley Station,9,17,-8,,,,,8,
94,3/1/2014,1482,28,Inbound,4199966,4200009,Malcolm X Blvd @ Tremont St,8,17,-9,,,,,9,
95,3/1/2014,1480,28,Inbound,4200009,4200084,Mattapan Station - South Busway,16,17,-1,,,,,1,
95,3/1/2014,1482,28,Inbound,4200009,4200084,Blue Hill Ave @ Fessenden St,15,17,-2,,,,,2,
95,3/1/2014,1484,28,Inbound,4200009,4200084,Blue Hill Ave @ Morton St,15,17,-2,,,,,2,
95,3/1/2014,1488,28,Inbound,4200009,4200084,Blue Hill Ave @ Talbot Ave,15,17,-2,,,,,2,
95,3/1/2014,1490,28,Inbound,4200009,4200084,Blue Hill Ave @ Ellington St - Franklin Park Zoo,16,17,-1,,,,,1,
95,3/1/2014,1493,28,Inbound,4200009,4200084,Warren St @ Quincy St,16,17,-1,,,,,1,
95,3/1/2014,1493,28,Inbound,4200009,4200084,Warren St @ Sunderland St,17,17,0,,,,,0,
95,3/1/2014,1496,28,Inbound,4200009,4200084,Warren St @ Moreland St,17,17,0,,,,,0,
95,3/1/2014,1498,28,Inbound,4200009,4200084,Dudley Station,18,17,1,,,,,1,
95,3/1/2014,1499,28,Inbound,4200009,4200084,Malcolm X Blvd @ Tremont St,19,17,2,,,,,2,
96,3/1/2014,1497,28,Inbound,4200084,4200056,Mattapan Station - South Busway,16,20,-4,,,,,4,
96,3/1/2014,1499,28,Inbound,4200084,4200056,Blue Hill Ave @ Fessenden St,49,20,29,,,,,29,
96,3/1/2014,1501,28,Inbound,4200084,4200056,Blue Hill Ave @ Morton St,50,20,30,,,,,30,
96,3/1/2014,1505,28,Inbound,4200084,4200056,Blue Hill Ave @ Talbot Ave,50,20,30,,,,,30,
96,3/1/2014,1507,28,Inbound,4200084,4200056,Blue Hill Ave @ Ellington St - Franklin Park Zoo,48,20,28,,,,,28,
96,3/1/2014,1510,28,Inbound,4200084,4200056,Warren St @ Quincy St,47,20,27,,,,,27,
96,3/1/2014,1510,28,Inbound,4200084,4200056,Warren St @ Sunderland St,47,20,27,,,,,27,
96,3/1/2014,1513,28,Inbound,4200084,4200056,Warren St @ Moreland St,47,20,27,,,,,27,
96,3/1/2014,1515,28,Inbound,4200084,4200056,Dudley Station,-1394,20,-1414,,,,,1414,
96,3/1/2014,1516,28,Inbound,4200084,4200056,Malcolm X Blvd @ Tremont St,-1394,20,-1414,,,,,1414,
